###### Your Results Are: ######
Name: Prof. Selma Alex Nair-Xin, V.
Citizen ID Num: 2ABF3D84D74093A8
First initial: S, Last initial: N.
Gender: masc. Pronouns: he/they.
DOB: Sep 10, 1967 - Age: 54 years.
Birthplace: Mejare and Tarak .
Primary Citizenship: Congo (Congo-Brazzaville)
Associate Citizenship(s): Djibouti, Wolf 1061c, Eswatini (fmr. "Swaziland"), Egypt, Grenada, Belgium.
Star Sign: Virgo.
------------------------------------------------
Height: 170.00 cm.
Mass:  75.14 kg.
Beliefs: Midewiwin.
Political Party membership: Church of the Militant Elvis Party
Relationship Status: Single. 
Children: None.
Known allergies: animal dander.
Blood type: O ₙₑᵍ
You are afraid of accidents.
Prexisting Health Conditions: Skin Condition controlled with diet & medication.
Dietary Restrictions: Words of Wisom.
Hobbies: Mountain biking and Radio-controlled model playing.
Languages: Spanish, Barsoomian.
Occupation: Refuse and Recyclable Material Collectors.
Security Clearance: None.
Criminal Record: No Criminal Convictions.
Arrest Record: No Arrests on File.
Warrants: No Active Warrants..
Networth: ¥94071.73.
Credit Score: 777.
Highest Education Achieved: Post Grad - ABD.
Last School Attended: Will O'Wisp Academy.
------------------------------------------------
Your:
        Childhood home was on Wyckham Road.
        First pet's name was Zuse.
        Childhood best-friend's name is Hong Bekele.
        First vehicle:  Jensen.
        Mother's maiden name: Lu.
        Fursona: Polar.
        Fighting Style: Suntukan.
        Superpower is: Can telekinetically manipulate paper.
------------------------------------------------
Your favourite/preferred:
        Colour is: Honeydew - #F0FFF0.
        Food is: Jasmine Rice.
        Ice Cream is: Chocolate Therapy.
        Poem is: Remember - Christina Georgina Rossetti.
        Flower is: Viburnum.
        Homestar Runner Character: The Prince of Town.
        Superhero is: Captain Marvel.
        Social Media Network is: Gab.
        Season is: Spring.
        Tree is: Schefflera attenuata[24].
        Emoji is: ⭐.
        Spectator Sport: Swimming.
        Cryptid is: Loch Ness Monster.
        Simpsons Character is: Brandine Spuckler
        Element is: Caesium - Cs
        Song is: Long Tall Sally by Little Richard.
        Holiday is: Valentine's Day.
        SCP is: SCP-809 - Combat Boots.
        Album is: The Score by Fugees.
        Steak doneness: Well Done - 5.
        Toast Doneness: 3.
        Hot Beverage: Earl Grey, hot.
        Tea/Coffee Colour: Black - A
        Soda is: Buziaș.
        Movie is: Unfaithfully Yours.
        Programming Language is: IBM RPG.
        Animal is: Hedgehog.
        Pokemon is: 144 Articuno.
        Book is: Black Beauty by Anna Sewell.
------------------------------------------------
