###### Your Results Are: ######
Name: Prof. Hong Laci Win-Lopez, III.
Citizen ID Num: 164181C35BDA2295
First initial: H, Last initial: W.
Gender: male. Pronouns: xe/xir.
DOB: Nov 26, 2004 - Age: 17 years.
Birthplace: Gamma X.
Primary Citizenship: Finland
Associate Citizenship(s): Zambia, Colombia.
Star Sign: Sagittarius.
------------------------------------------------
Height: 63.00 cm.
Mass:  7.94 kg.
Beliefs: No strong philosophical or religious beliefs..
Political Party membership: Adam Lyal's Witchery Tour Party¬†
Relationship Status: Single. 
Children: None.
Known allergies: none.
Blood type: A ‚Çô·µ§‚Çó‚Çó
You are afraid of speaking in public.
Prexisting Health Conditions: Asthma controlled with diet & medication.
Dietary Restrictions: Pescatarian.
Hobbies: Meditation.
Languages: Telugu, Uropi and Klingon.
Occupation: Offset Press Operators.
Security Clearance: None.
Criminal Record: No Criminal Convictions.
Arrest Record: No Arrests on File.
Warrants: No Active Warrants..
Networth: ¬•3642523.84.
Credit Score: 817.
Highest Education Achieved: Undergraduate.
Last School Attended: Wrottesley Polytechnic.
------------------------------------------------
Your:
        Childhood home was on Woodcote Passage.
        First pet's name was Sabertooth.
        Childhood best-friend's name is Vladimir Sarkar.
        First vehicle:  White.
        Mother's maiden name: Kobayashi.
        Fursona: Cow.
        Fighting Style: V·∫≠t c·ªï truy·ªÅn).
        Superpower is: Everything you put in your mouth tastes awful.
------------------------------------------------
Your favourite/preferred:
        Colour is: Fulvous - #E48400.
        Food is: Cherry Limeade.
        Ice Cream is: Aloha Macadamia.
        Poem is: Dreams - Langston Hughes.
        Flower is: Eustoma.
        Homestar Runner Character: Lotionman.
        Superhero is: The Rocketeer.
        Social Media Network is: Focus.com.
        Season is: Summer.
        Tree is: Quercus calliprinos.
        Emoji is: üò≠.
        Spectator Sport: Rugby.
        Cryptid is: Trinity Alps giant salamander.
        Simpsons Character is: Jessica Lovejoy
        Element is: Administratium
        Song is: Desperado by The Eagles.
        Holiday is: Easter.
        SCP is: SCP-676¬†- Unnatural Hot Spring.
        Album is: ...Baby One More Time by Britney Spears.
        Steak doneness: Medium Rare - 2.
        Toast Doneness: 4.
        Hot Beverage: Coffee.
        Tea/Coffee Colour: White - F
        Soda is: Coca-Cola Life.
        Movie is: Lonesome[17]¬†[18].
        Programming Language is: A-0 System.
        Animal is: Echidna.
        Pokemon is: 772 Type: Null.
        Book is: The Lovely Bones by Alice Sebold.
------------------------------------------------
