###### Your Results Are: ######
Name: Col. Daniella Nasreen Karim-Huang, V.
Citizen ID Num: 7FBB7CA3ACC3DE89
First initial: D, Last initial: K.
Gender: none. Pronouns: ey/em.
DOB: Feb 18, 1921 - Age: 100 years.
Birthplace: Terminus .
Primary Citizenship: Monaco
Associate Citizenship(s): Egypt, Kepler-705b.
Star Sign: Aquarius.
------------------------------------------------
Height: 238.00 cm.
Mass:  152.94 kg.
Beliefs: Thenkalais.
Political Party membership: Ikea Meatball Party
Relationship Status: 6 loving partner(s). 
Children: None.
Known allergies: aspirin.
Blood type: B ₙᵤₗₗ
You are afraid of flying.
Prexisting Health Conditions: HIV/AIDS controlled with diet & medication.
Dietary Restrictions: Vegan.
Hobbies: Polo.
Languages: South Azerbaijani, Pakuni.
Occupation: Fraud Investigator.
Security Clearance: None.
Criminal Record: Criminal Convictions on File.
Arrest Record: Arrest Record on File.
Warrants: No Active Warrants..
Networth: ¥781993.93.
Credit Score: 777.
Highest Education Achieved: Undergraduate.
Last School Attended: Chalet School.
------------------------------------------------
Your:
        Childhood home was on Burn Ridings.
        First pet's name was Daisy Rose.
        Childhood best-friend's name is Sherell Campos.
        First vehicle:  Cole.
        Mother's maiden name: Juma.
        Fursona: Otter/Wolf.
        Fighting Style: Southern Dragon Kung Fu.
        Superpower is: Sliding.
------------------------------------------------
Your favourite/preferred:
        Colour is: Blue (pigment) - #333399.
        Food is: Chicken Tikka Masala.
        Ice Cream is: Chocolate Hazelnut Swirl.
        Poem is: Hope - Emily Jane Bronte.
        Flower is: Phlox.
        Homestar Runner Character: Peacey P.
        Superhero is: Watchmen.
        Social Media Network is: LibraryThing.
        Season is: Winter.
        Tree is: Carpinus caroliniana.
        Emoji is: ✅.
        Spectator Sport: Motor Sport Racing.
        Cryptid is: Ogopogo.
        Simpsons Character is: Lenny Leonard
        Element is: Francium - Fr
        Song is: Good Golly Miss Molly by Little Richard.
        Holiday is: Diwali.
        SCP is: SCP-187 - Double Vision.
        Album is: Saturday Night Fever by Bee Gees.
        Steak doneness: Shoe Leather - 6.
        Toast Doneness: 2.
        Hot Beverage: Monster.
        Tea/Coffee Colour: White - F
        Soda is: National Beverage.
        Movie is: Bull Durham.
        Programming Language is: Language H.
        Animal is: Sloth.
        Pokemon is: 420 Cherubi.
        Book is: Fear of Flying by Erica Jong.
------------------------------------------------
