###### Your Results Are: ######
Name: St. Ezequiel Kasandra Chowdhury-Ferreira, III.
Citizen ID Num: E13D2F94D7A041CA
First initial: E, Last initial: C.
Gender: femme. Pronouns: they/them.
DOB: Feb 9, 1949 - Age: 72 years.
Birthplace: Ragnarok¬†.
Primary Citizenship: Lesotho
Associate Citizenship(s): Serbia, Kepler-1544b, Senegal, Pakistan, Kepler-1229b, Wolf 1061c.
Star Sign: Aquarius.
------------------------------------------------
Height: 254.00 cm.
Mass:  148.39 kg.
Beliefs: No strong philosophical or religious beliefs..
Political Party membership: Polish Beer-Lovers' Party
Relationship Status: 7 loving partner(s). 
Children: None.
Known allergies: none.
Blood type: A ‚Çô‚Çë·µç
You are afraid of animals.
Prexisting Health Conditions: St. Vitus' Dance controlled with diet & medication.
Dietary Restrictions: Lemba.
Hobbies: Filmmaking.
Languages: Polish, Kazakh, Adjuvilo.
Occupation: Human Resources Management Advisor.
Security Clearance: SBU.
Criminal Record: No Criminal Convictions.
Arrest Record: No Arrests on File.
Warrants: No Active Warrants..
Networth: ¬•4720520.60.
Credit Score: 747.
Highest Education Achieved: Primary School.
Last School Attended: The School of Magic on Roke Island.
------------------------------------------------
Your:
        Childhood home was on Roebuck Gate.
        First pet's name was Buster Posey.
        Childhood best-friend's name is Samira Barros.
        First vehicle:  Thomas.
        Mother's maiden name: Escobar.
        Fursona: None.
        Fighting Style: Lutte Traditionnelle.
        Superpower is: Your fingers cause mechanical devices to seize.
------------------------------------------------
Your favourite/preferred:
        Colour is: Cadet - #536872.
        Food is: Calamansi Drink.
        Ice Cream is: Heath Bar Crunch Light Ice Cream.
        Poem is: A Tear And A Smile - Khalil Gibran.
        Flower is: Dianthus barbatus.
        Sleepwear is: t-shirt and panties.
        Homestar Runner Character: Animatronic Strong Bad.
        Superhero is: Watchmen.
        Social Media Network is: DeviantArt.
        Season is: Summer.
        Tree is: Borassus aethiopum.
        Emoji is: üôà.
        Spectator Sport: Swimming.
        Cryptid is: Igopogo.
        Simpsons Character is: Marvin Monroe[C]
        Element is: Truthitonium
        Song is: Rain by The Beatles.
        Holiday is: Passover.
        SCP is: SCP-2383-J¬†- Science.
        Album is: Like a Virgin by Madonna.
        Steak doneness: Shoe Leather - 6.
        Toast Doneness: 4.
        Hot Beverage: Monster.
        Tea/Coffee Colour: D
        Soda is: Irn-Bru.
        Movie is: Jour de f√™te.
        Programming Language is: Python.
        Animal is: laboratory rat strains.
        Pokemon is: 56 Mankey.
        Book is: To Kill A Mockingbird by Harper Lee.
------------------------------------------------
