###### Your Results Are: ######
Name: Karol Elly Toure-Pradhan.
Citizen ID Num: 3E4B83014687A59E
First initial: K, Last initial: T.
Gender: nonbinary. Pronouns: she/they.
DOB: Nov 3, 1998 - Age: 23 years.
Birthplace: Ceti Alpha V.
Primary Citizenship: Saint Kitts and Nevis
Associate Citizenship(s): Gliese 229 Ac, Kepler-26e, Russia, India, Comoros, Holy See.
Star Sign: Scorpio.
------------------------------------------------
Height: 175.00 cm.
Mass:  104.12 kg.
Beliefs: Our Lady of Endor Coven .
Political Party membership: Inanimate Objects Party
Relationship Status: Single. 
Children: 1 children.
Known allergies: cows' milk.
Blood type: B ₚₒₛ
You are afraid of phobias.
Prexisting Health Conditions: Sleep problems controlled with diet & medication.
Dietary Restrictions: Lemba.
Hobbies: Outdoors.
Languages: Burmese, North Levantine Arabic, E-Prime.
Occupation: Fishery Worker Supervisor.
Security Clearance: None.
Criminal Record: No Criminal Convictions.
Arrest Record: No Arrests on File.
Warrants: No Active Warrants..
Networth: ¥4401668.12.
Credit Score: 426.
Highest Education Achieved: Primary School.
Last School Attended: The Black School.
------------------------------------------------
Your:
        Childhood home was on Love Newydd.
        First pet's name was Misty Pearl.
        Childhood best-friend's name is Joanna Müller.
        First vehicle:  Morgan.
        Mother's maiden name: Sousa.
        Fursona: None.
        Fighting Style: Vật cổ truyền).
        Superpower is: Every full moon.
------------------------------------------------
Your favourite/preferred:
        Colour is: Mauve taupe - #915F6D.
        Food is: Chorizo.
        Ice Cream is: Cherry Garcia The Bar.
        Poem is: The Highwayman - Alfred Noyes.
        Flower is: Alstroemeria.
        Sleepwear is: t-shirt and boxer briefs.
        Homestar Runner Character: Stooly.
        Superhero is: Supergirl.
        Social Media Network is: Tumblr.
        Season is: Summer.
        Tree is: Malpighiaceae.
        Emoji is: ❣️.
        Spectator Sport: Football.
        Cryptid is: Elwetritsch.
        Simpsons Character is: Krusty The Clown
        Element is: Unobtanium
        Song is: Black Dog by Led Zeppelin.
        Holiday is: Mardi Gras.
        SCP is: SCP-3V1L-J - The Master Plan.
        Album is: Bridge over Troubled Water by Simon & Garfunkel.
        Steak doneness: Blue - 0.
        Toast Doneness: Burnt - 6.
        Hot Beverage: Monster.
        Tea/Coffee Colour: D
        Soda is: Pepsi Jazz Black Cherry & Vanilla.
        Movie is: Canoa: A Shameful Memory.
        Programming Language is: Kotlin.
        Animal is: Parrotfish.
        Pokemon is: 812 Rillaboom.
        Book is: The Poky Little Puppy by Janette Sebring Lowrey.
------------------------------------------------
