###### Your Results Are: ######
Name: General Verena Lakeesha Moreno-Soe, Sr..
Citizen ID Num: F3CEA8BA43AE7D4B
First initial: V, Last initial: M.
Gender: masc. Pronouns: she/her.
DOB: Jan 11, 1973 - Age: 48 years.
Birthplace: Hiigara¬†.
Primary Citizenship: Kepler-1410b
Associate Citizenship(s): Maldives, Ethiopia, Azerbaijan, North Korea.
Star Sign: Capricorn.
------------------------------------------------
Height: 55.00 cm.
Mass:  6.35 kg.
Beliefs: No strong philosophical or religious beliefs..
Political Party membership: Sarmu probo nisi:
Relationship Status: Single. 
Children: 5 children.
Known allergies: none.
Blood type: B ‚Çö‚Çí‚Çõ
You are afraid of speed.
Prexisting Health Conditions: Cholesterol controlled with diet & medication.
Dietary Restrictions: Pescatarian.
Hobbies: Dog training and Renaissance fair.
Languages: Indonesian Malay, Polish, Bolak and Neo.
Occupation: Sales Representative (Radio & TV Time).
Security Clearance: None.
Criminal Record: No Criminal Convictions.
Arrest Record: No Arrests on File.
Warrants: No Active Warrants..
Networth: ¬•5166887.22.
Credit Score: 417.
Highest Education Achieved: Post-Doc.
Last School Attended: William McKinley High School.
------------------------------------------------
Your:
        Childhood home was on Richards Glas.
        First pet's name was Bode Vonn.
        Childhood best-friend's name is Sangeeta Sresth.
        First vehicle:  McLaren.
        Mother's maiden name: Sahani.
        Fursona: Vulpix.
        Fighting Style: V·∫≠t c·ªï truy·ªÅn).
        Superpower is: Detachable arms.
------------------------------------------------
Your favourite/preferred:
        Colour is: Crimson - #DC143C.
        Food is: Kettle Corn.
        Ice Cream is: Blondies are a Swirl's Best Friend.
        Poem is: Mother To Son - Langston Hughes.
        Flower is: Chicory.
        Sleepwear is: vest and boxers.
        Homestar Runner Character: Mancuso's Older Brother.
        Superhero is: Green Lantern.
        Social Media Network is: Gaia Online.
        Season is: Winter.
        Tree is: Mora excelsa.
        Emoji is: üòú.
        Spectator Sport: Rollerblading.
        Cryptid is: Beast of Exmoor.
        Simpsons Character is: Mr. Burns
        Element is: Chlorophyte
        Song is: Cathy's Clown by Everly Brothers.
        Holiday is: Easter.
        SCP is: SCP-810¬†- The Never-want Lamp.
        Album is: Gold: Greatest Hits by ABBA.
        Steak doneness: Medium Well - 4.
        Toast Doneness: 3.
        Hot Beverage: Coffee.
        Tea/Coffee Colour: B
        Soda is: Mecca Cola.
        Movie is: I Knew Her Well.
        Programming Language is: QuakeC.
        Animal is: Cat.
        Pokemon is: 794 Buzzwole¬†‚ôØ.
        Book is: A Message to Garcia by Elbert Hubbard.
------------------------------------------------
