###### Your Results Are: ######
Name: Sammie Lydia James-Babu.
Citizen ID Num: F796023EB7CD90B8
First initial: S, Last initial: J.
Gender: masc. Pronouns: xe/xir.
DOB: Oct 28, 1931 - Age: 90 years.
Birthplace: AldÃ©baran-4Â .
Primary Citizenship: Namibia
Associate Citizenship(s): Lesotho, Kepler-174d.
Star Sign: Scorpio.
------------------------------------------------
Height: 115.00 cm.
Mass:  29.09 kg.
Beliefs: No strong philosophical or religious beliefs..
Political Party membership: Rapaille PartijÂ 
Relationship Status: 2 loving partner(s). 
Children: 5 children.
Known allergies: none.
Blood type: O â‚™áµ¤â‚—â‚—
You are afraid of sleep.
Prexisting Health Conditions: Covid-72 controlled with diet & medication.
Dietary Restrictions: Words of Wisom.
Hobbies: Wine tasting and Public transport riding.
Languages: Western Punjabi, Nepali, E-Prime and E-Prime.
Occupation: Wildlife Biologist.
Security Clearance: None.
Criminal Record: No Criminal Convictions.
Arrest Record: No Arrests on File.
Warrants: No Active Warrants..
Networth: Â¥1090788.16.
Credit Score: 601.
Highest Education Achieved: Post-Graduate.
Last School Attended: Roanoke Academy for the Sorcerous Arts.
------------------------------------------------
Your:
        Childhood home was on Golden Mount.
        First pet's name was Martha.
        Childhood best-friend's name is Ruthe Moussa.
        First vehicle:  Westcott.
        Mother's maiden name: Cauhan.
        Fursona: Skink.
        Fighting Style: Coblete.
        Superpower is: Can turn music into beams of light.
------------------------------------------------
Your favourite/preferred:
        Colour is: Cultured - #F5F5F5.
        Food is: Pizza.
        Ice Cream is: French Vanilla.
        Poem is: The Road Not Taken - Robert Frost.
        Flower is: Maltese Cross.
        Sleepwear is: vest and trousers.
        Homestar Runner Character: Sir Loodabert Comma.
        Superhero is: Zatanna.
        Social Media Network is: Talkbiznow.
        Season is: Winter.
        Tree is: Albizia gummifera.
        Emoji is: ðŸŒ¸.
        Spectator Sport: Water polo.
        Cryptid is: Yeren.
        Simpsons Character is: Sideshow Mel
        Element is: Element Zero (0-Ez)
        Song is: Smokestack Lightnin by Howlin' Wolf.
        Holiday is: New Year.
        SCP is: SCP-440Â - Sand-Based Ecology.
        Album is: Grease: The Original Soundtrack from the Motion Picture by the Motion Picture Cast.
        Steak doneness: Rare - 1.
        Toast Doneness: 4.
        Hot Beverage: Bovril.
        Tea/Coffee Colour: B
        Soda is: Highland Spring.
        Movie is: Diary of a Chambermaid.
        Programming Language is: Join Java.
        Animal is: Orangutan.
        Pokemon is: 520 Tranquill.
        Book is: Interpreter of Maladies by Jhumpa Lahiri.
------------------------------------------------
