###### Your Results Are: ######
Name: Ensign Salim Halima Aguilar-Suarez.
Citizen ID Num: 9B3A4425E5C3A77A
First initial: S, Last initial: A.
Gender: nonbinary. Pronouns: he/they.
DOB: May 30, 1935 - Age: 86 years.
Birthplace: Palamok¬†.
Primary Citizenship: Portugal
Associate Citizenship(s): ['None'].
Star Sign: Gemini.
------------------------------------------------
Height: 260.00 cm.
Mass:  108.16 kg.
Beliefs: No strong philosophical or religious beliefs..
Political Party membership: Royalist Party of Estonia
Relationship Status: Single. 
Children: 4 children.
Known allergies: hair dyes.
Blood type: AB ‚Çô‚Çë·µç
You are afraid of teenagers.
Prexisting Health Conditions: Neurology controlled with diet & medication.
Dietary Restrictions: Halal.
Hobbies: Sewing.
Languages: Deccan, Enchanta.
Occupation: Transit and Railroad Police.
Security Clearance: None.
Criminal Record: No Criminal Convictions.
Arrest Record: No Arrests on File.
Warrants: No Active Warrants..
Networth: ¬•1004416.75.
Credit Score: 770.
Highest Education Achieved: Post Grad - ABD.
Last School Attended: St Luke's University Bristol.
------------------------------------------------
Your:
        Childhood home was on Balmoral Village.
        First pet's name was Gertrude.
        Childhood best-friend's name is Jianwei Hill.
        First vehicle:  Caterham.
        Mother's maiden name: Sheng.
        Fursona: Alien.
        Fighting Style: Baguazhang.
        Superpower is: Can make the sound of a tree falling in the forest with no one to hear it.
------------------------------------------------
Your favourite/preferred:
        Colour is: Black - #000000.
        Food is: Pizza.
        Ice Cream is: White Russian.
        Poem is: Carpe Diem - William Shakespeare.
        Flower is: Goldenrod.
        Sleepwear is: bra and trousers.
        Homestar Runner Character: Tim Tom.
        Superhero is: Captain America.
        Social Media Network is: Cloob.
        Season is: Summer.
        Tree is: Cecropia schreberiana.
        Emoji is: üíò.
        Spectator Sport: Skiing.
        Cryptid is: Lizard Man of Scape Ore Swamp.
        Simpsons Character is: Dolph Starbeam
        Element is: Roentgenium - Rg
        Song is: For What It's Worth (Stop.
        Holiday is: Mother's Day.
        SCP is: SCP-789¬†- Internet Predator.
        Album is: Metallica by Metallica.
        Steak doneness: Medium Rare - 2.
        Toast Doneness: done on one side.
        Hot Beverage: Earl Grey, hot.
        Tea/Coffee Colour: White - F
        Soda is: Coca-Cola with Lime.
        Movie is: I Know Where I'm Going!.
        Programming Language is: HyperTalk.
        Animal is: Sperm whale.
        Pokemon is: 783 Hakamo-o.
        Book is: The Horse Whisperer by Nicholas Evans.
------------------------------------------------
