###### Your Results Are: ######
Name: Nenita Sherice Gibson-Lestari, Esq..
Citizen ID Num: 4E4F6FB6E676488F
First initial: N, Last initial: G.
Gender: complicated. Pronouns: he/him.
DOB: Jun 19, 1914 - Age: 107 years.
Birthplace: Fyrine IV.
Primary Citizenship: Afghanistan
Associate Citizenship(s): Montenegro, Armenia, Grenada, Guyana, Wolf 1061c, Libya, TRAPPIST-1d.
Star Sign: Gemini.
------------------------------------------------
Height: 258.00 cm.
Mass:  126.47 kg.
Beliefs: Blue Star Wicca.
Political Party membership: Best Party
Relationship Status: Single. 
Children: None.
Known allergies: none.
Blood type: O ₚₒₛ
You are afraid of Halloween.
Prexisting Health Conditions: Women's Health Issues controlled with diet & medication.
Dietary Restrictions: Pescatarian.
Hobbies: Vinyl Records.
Languages: Taʽizzi-Adeni Arabic, Enchanta and Barsoomian.
Occupation: Family Caseworker.
Security Clearance: None.
Criminal Record: No Criminal Convictions.
Arrest Record: No Arrests on File.
Warrants: No Active Warrants..
Networth: ¥3611769.86.
Credit Score: 338.
Highest Education Achieved: Post-Doc.
Last School Attended: John Adams Middle School.
------------------------------------------------
Your:
        Childhood home was on Marsh Road.
        First pet's name was Brunswick (Bruno).
        Childhood best-friend's name is Andera Pawar.
        First vehicle:  Rivian.
        Mother's maiden name: Cortes.
        Fursona: None.
        Fighting Style: Moraingy.
        Superpower is: Communication with bacteria.
------------------------------------------------
Your favourite/preferred:
        Colour is: Fiery rose - #FF5470.
        Food is: Croissant.
        Ice Cream is: Blueberry Ice Cream.
        Poem is: Where The Mind Is Without Fear - Rabindranath Tagore.
        Flower is: Blazing Star.
        Sleepwear is: t-shirt.
        Homestar Runner Character: Homsar.
        Superhero is: Thor.
        Social Media Network is: Piczo.
        Season is: Autumn.
        Tree is: Cecropia.
        Emoji is: ✋.
        Spectator Sport: Weightlifting.
        Cryptid is: Igopogo.
        Simpsons Character is: Martin Prince
        Element is: Radon - Rn
        Song is: Free Bird by Lynyrd Skynyrd.
        Holiday is: Passover.
        SCP is: SCP-184 - The Architect.
        Album is: Abbey Road by The Beatles.
        Steak doneness: Rare - 1.
        Toast Doneness: White - 0.
        Hot Beverage: Tea.
        Tea/Coffee Colour: B
        Soda is: Wild Strawberry.
        Movie is: Lucía.
        Programming Language is: Join Java.
        Animal is: Lobster.
        Pokemon is: 178 Xatu.
        Book is: Fahrenheit 451 by Ray Bradbury.
------------------------------------------------
