###### Your Results Are: ######
Name: Daniella Mahesh Lu-Ba, III.
Citizen ID Num: F277A1DF0B5303B0
First initial: D, Last initial: L.
Gender: none. Pronouns: she/her.
DOB: Jan 14, 1974 - Age: 47 years.
Birthplace: Abydos.
Primary Citizenship: Kepler-296f
Associate Citizenship(s): Kiribati, Iran, K2-288Bb, Honduras, North Macedonia.
Star Sign: Capricorn.
------------------------------------------------
Height: 130.00 cm.
Mass:  33.80 kg.
Beliefs: Dievturƒ´ba.
Political Party membership: No Party to Support
Relationship Status: 7 loving partner(s). 
Children: 5 children.
Known allergies: animal dander.
Blood type: AB ‚Çô·µ§‚Çó‚Çó
You are afraid of feet.
Prexisting Health Conditions: Oral Health Issues controlled with diet & medication.
Dietary Restrictions: Gluten-free.
Hobbies: Scouting and Juggling.
Languages: Bavarian, Sa Ωidi Arabic, Bartonian and Interlingua.
Occupation: Government Budget Analyst.
Security Clearance: None.
Criminal Record: Criminal Convictions on File.
Arrest Record: Arrest Record on File.
Warrants: No Active Warrants..
Networth: ¬•4170005.15.
Credit Score: 348.
Highest Education Achieved: Post-Graduate.
Last School Attended: Poltowan University.
------------------------------------------------
Your:
        Childhood home was on Cornfield Lawns.
        First pet's name was CocoBean.
        Childhood best-friend's name is Terisa Shimizu.
        First vehicle:  Riversimple.
        Mother's maiden name: Adams.
        Fursona: None.
        Fighting Style: Naginatajutsu.
        Superpower is: Can recite any bible verse on command.
------------------------------------------------
Your favourite/preferred:
        Colour is: CG red - #E03C31.
        Food is: Adobo.
        Ice Cream is: Coffee Toffee Crunch.
        Poem is: The Rear-Guard - Siegfried Sassoon.
        Flower is: Borage.
        Sleepwear is: trousers.
        Homestar Runner Character: Trivia Time.
        Superhero is: Batwoman.
        Social Media Network is: Wattpad.
        Season is: Summer.
        Tree is: Quercus muehlenbergii.
        Emoji is: üòÅ.
        Spectator Sport: Auto-Racing.
        Cryptid is: Bunyip.
        Simpsons Character is: Luann Van Houten
        Element is: Polonium - Po
        Song is: I Put a Spell on You by Screamin' Jay Hawkins.
        Holiday is: Mardi Gras.
        SCP is: SCP-217¬†- The Clockwork Virus.
        Album is: Greatest Hits by Queen.
        Steak doneness: Medium Rare - 2.
        Toast Doneness: 5.
        Hot Beverage: Coffee.
        Tea/Coffee Colour: D
        Soda is: Damavand.
        Movie is: Alice in Wonderland.
        Programming Language is: Elixir.
        Animal is: Wolf.
        Pokemon is: 494 Victini.
        Book is: Your Erroneous Zones by Wayne Dyer.
------------------------------------------------
