###### Your Results Are: ######
Name: Lcpl Farida Windy Akram-Evans.
Citizen ID Num: 80D28639C41BCC05
First initial: F, Last initial: A.
Gender: complicated. Pronouns: he/they.
DOB: Feb 23, 1909 - Age: 112 years.
Birthplace: OnyxÂ .
Primary Citizenship: Serbia
Associate Citizenship(s): Australia, Gliese 229 Ac, Kepler-1540b, United Kingdom, Canada.
Star Sign: Pisces.
------------------------------------------------
Height: 189.00 cm.
Mass:  85.73 kg.
Beliefs: Word of Faith.
Political Party membership: The Civilian PartyÂ 
Relationship Status: Single. 
Children: None.
Known allergies: fruit.
Blood type: B â‚šâ‚’â‚›
You are afraid of computers.
Prexisting Health Conditions: Heart Problems controlled with diet & medication.
Dietary Restrictions: Vegan.
Hobbies: Stamp collecting and Geography.
Languages: South Azerbaijani, Ido.
Occupation: Plant Breeder.
Security Clearance: None.
Criminal Record: No Criminal Convictions.
Arrest Record: No Arrests on File.
Warrants: No Active Warrants..
Networth: Â¥900927.20.
Credit Score: 566.
Highest Education Achieved: Post-Graduate.
Last School Attended: The Colleges of Magic.
------------------------------------------------
Your:
        Childhood home was on Whitworth Holt.
        First pet's name was Calamity Anne Taylor.
        Childhood best-friend's name is Eliseo Peng.
        First vehicle:  Hawk.
        Mother's maiden name: Bahadur.
        Fursona: Klee Kia.
        Fighting Style: China.
        Superpower is: Cheese Manipulation.
------------------------------------------------
Your favourite/preferred:
        Colour is: Mint green - #98FF98.
        Food is: Crab Legs.
        Ice Cream is: Strawberry Ice.
        Poem is: The Rose That Grew From Concrete - Tupac Shakur.
        Flower is: Carnation.
        Sleepwear is: bra and panties.
        Homestar Runner Character: Grandmaw Auntpaw.
        Superhero is: Superman.
        Social Media Network is: Sina Weibo.
        Season is: Autumn.
        Tree is: Box (Buxus sempervirens).
        Emoji is: ðŸ˜š.
        Spectator Sport: Netball.
        Cryptid is: Selma.
        Simpsons Character is: Sideshow Bob
        Element is: Red Mercury - ??
        Song is: Hotel California by The Eagles.
        Holiday is: Purim.
        SCP is: SCP-1914-JÂ - Silencing Piano.
        Album is: The Dark Side of the Moon by Pink Floyd.
        Steak doneness: Medium - 3.
        Toast Doneness: Burnt - 6.
        Hot Beverage: Bovril.
        Tea/Coffee Colour: E
        Soda is: Britvic.
        Movie is: Minions.
        Programming Language is: EPL (Eltron Programming Language).
        Animal is: Quetzal.
        Pokemon is: 367 Huntail.
        Book is: What Color Is Your Parachute? by Richard Nelson Bolles.
------------------------------------------------
