###### Your Results Are: ######
Name: Col. Jim Jinny Smith-Gutierrez, IV.
Citizen ID Num: 012F481C122C52AC
First initial: J, Last initial: S.
Gender: female. Pronouns: ey/em.
DOB: May 1, 1992 - Age: 29 years.
Birthplace: Fhloston¬†.
Primary Citizenship: Rwanda
Associate Citizenship(s): Proxima Centauri b, Bahamas.
Star Sign: Taurus.
------------------------------------------------
Height: 129.00 cm.
Mass:  29.95 kg.
Beliefs: Moorish Orthodox Church of America.
Political Party membership: Partidul Liber-Schimbist¬†
Relationship Status: Single. 
Children: 1 children.
Known allergies: none.
Blood type: O ‚Çô‚Çë·µç
You are afraid of paper.
Prexisting Health Conditions: Menopause controlled with diet & medication.
Dietary Restrictions: Gluten-free.
Hobbies: Rugby.
Languages: Bengali, Rundi, Bartonian and Lingwa de planeta.
Occupation: Title Examiner.
Security Clearance: None.
Criminal Record: No Criminal Convictions.
Arrest Record: No Arrests on File.
Warrants: No Active Warrants..
Networth: ¬•1097385.84.
Credit Score: 750.
Highest Education Achieved: Post-Doc.
Last School Attended: Camden College.
------------------------------------------------
Your:
        Childhood home was on Clover Glebe.
        First pet's name was Dolly.
        Childhood best-friend's name is Arturo Leng.
        First vehicle:  Chalmers.
        Mother's maiden name: Mustafa.
        Fursona: None.
        Fighting Style: Kory≈´ Bujutsu.
        Superpower is: Balloon Mimicry.
------------------------------------------------
Your favourite/preferred:
        Colour is: Beige - #F5F5DC.
        Food is: Chocolate Chip Cookies.
        Ice Cream is: Peanut Butter Truffle.
        Poem is: From: War Is Kind - Stephen Maria Crane.
        Flower is: Agapanthus.
        Sleepwear is: vest and boxers.
        Homestar Runner Character: Tire.
        Superhero is: Doc Savage.
        Social Media Network is: Edmodo.
        Season is: Summer.
        Tree is: Ficus sur.
        Emoji is: üòû.
        Spectator Sport: Rugby League.
        Cryptid is: Dingonek.
        Simpsons Character is: Carl Carlson
        Element is: Molybdenum - Mo
        Song is: That'll Be the Day by Buddy Holly.
        Holiday is: Christmas.
        SCP is: SCP-789-J¬†- the butt ghost!!.
        Album is: The Score by Fugees.
        Steak doneness: Blue - 0.
        Toast Doneness: 5.
        Hot Beverage: Monster.
        Tea/Coffee Colour: E
        Soda is: Gini.
        Movie is: The Cloud-Capped Star.
        Programming Language is: PortablE.
        Animal is: Oryx.
        Pokemon is: 52 Meowth.
        Book is: Sophie‚Äôs World by Jostein Gaarder.
------------------------------------------------
