###### Your Results Are: ######
Name: Ensign Aleksandr Tu Tahir-Docherty.
Citizen ID Num: 9B0B37EDECC3193A
First initial: A, Last initial: T.
Gender: none. Pronouns: any.
DOB: Oct 9, 1995 - Age: 26 years.
Birthplace: GorÂ .
Primary Citizenship: Farms of Merryville
Associate Citizenship(s): K2-72e, Kepler-26e, Tonga.
Star Sign: Libra.
------------------------------------------------
Height: 196.00 cm.
Mass:  65.31 kg.
Beliefs: Jivaroan religion.
Political Party membership: The Party Party
Relationship Status: 6 loving partner(s). 
Children: 3 children.
Known allergies: aspirin.
Blood type: B â‚™áµ¤â‚—â‚—
You are afraid of women.
Prexisting Health Conditions: Heart Problems controlled with diet & medication.
Dietary Restrictions: Kosher.
Hobbies: Art and Miniature art.
Languages: Uyghur, Malayalam, KobaÃ¯an.
Occupation: Personnel Assistant.
Security Clearance: None.
Criminal Record: Criminal Convictions on File.
Arrest Record: Arrest Record on File.
Warrants: No Active Warrants..
Networth: Â¥2282614.12.
Credit Score: 411.
Highest Education Achieved: Secondary School.
Last School Attended: The Little Female Academy.
------------------------------------------------
Your:
        Childhood home was on Richards Chase.
        First pet's name was Azula (ZuZu).
        Childhood best-friend's name is Krishna Su.
        First vehicle:  Chrysler.
        Mother's maiden name: Cho.
        Fursona: None.
        Fighting Style: Chin Na.
        Superpower is: Can forsee the future.
------------------------------------------------
Your favourite/preferred:
        Colour is: Maximum red purple - #A63A79.
        Food is: Mussels.
        Ice Cream is: Nutcracker Suite.
        Poem is: Sonnet: When I Have Fears That I May Cease To Be - John Keats.
        Flower is: Heliotrope.
        Sleepwear is: t-shirt and boxer briefs.
        Homestar Runner Character: Dijjery Doo.
        Superhero is: Robin.
        Social Media Network is: Dol2day.
        Season is: Winter.
        Tree is: Curatella americana.
        Emoji is: ðŸ˜ˆ.
        Spectator Sport: Volleyball.
        Cryptid is: Kusshii.
        Simpsons Character is: Bleeding Gums Murphy[B]
        Element is: Meteorillium
        Song is: In Dreams by Roy Orbison.
        Holiday is: Yom Kippur.
        SCP is: SCP-702Â - The Trader's Residence.
        Album is: Tapestry by Carole King.
        Steak doneness: Blue - 0.
        Toast Doneness: White - 0.
        Hot Beverage: Tea.
        Tea/Coffee Colour: E
        Soda is: Pet.
        Movie is: Police Story.
        Programming Language is: DYNAMO.
        Animal is: Ox.
        Pokemon is: 17 Pidgeotto.
        Book is: Knowledge-Value Revolution by Taichi Sakaiya.
------------------------------------------------
