###### Your Results Are: ######
Name: Pvt. Buddy Marta Brooks-Sasaki.
Citizen ID Num: 85664E2519EF9CDB
First initial: B, Last initial: B.
Gender: femme. Pronouns: he/they.
DOB: Nov 17, 1990 - Age: 31 years.
Birthplace: Tran .
Primary Citizenship: Guinea-Bissau
Associate Citizenship(s): Dominica, Sri Lanka, Bolivia.
Star Sign: Scorpio.
------------------------------------------------
Height: 88.00 cm.
Mass:  20.13 kg.
Beliefs: New Confucianism.
Political Party membership: Sarmu probo nisi:
Relationship Status: Single. 
Children: None.
Known allergies: shellfish.
Blood type: B ₙₑᵍ
You are afraid of numbers.
Prexisting Health Conditions: Neurology controlled with diet & medication.
Dietary Restrictions: Pescatarian.
Hobbies: Building.
Languages: Sindhi, Dutch, Eskayan and Lincos.
Occupation: Community Health Nurse.
Security Clearance: None.
Criminal Record: Criminal Convictions on File.
Arrest Record: Arrest Record on File.
Warrants: No Active Warrants..
Networth: ¥2177192.48.
Credit Score: 744.
Highest Education Achieved: Primary School.
Last School Attended: Fibchester University.
------------------------------------------------
Your:
        Childhood home was on Birchfield Hill.
        First pet's name was Chopin.
        Childhood best-friend's name is Tonda Singh.
        First vehicle:  Atlantis.
        Mother's maiden name: Shu.
        Fursona: Mew.
        Fighting Style: Gladiatura Moderna.
        Superpower is: Can teleport 1 inch in front of you.
------------------------------------------------
Your favourite/preferred:
        Colour is: Burgundy - #800020.
        Food is: Chicken and Dumplings.
        Ice Cream is: Makin' Whoopie Pie.
        Poem is: On The Ning Nang Nong - Spike Milligan.
        Flower is: Clover.
        Sleepwear is: bra.
        Homestar Runner Character: The Fat Bee.
        Superhero is: The Defenders.
        Social Media Network is: Peach.
        Season is: Winter.
        Tree is: Petitia domingensis.
        Emoji is: ✋.
        Spectator Sport: Tennis.
        Cryptid is: Thunderbird.
        Simpsons Character is: Legs
        Element is: Magnesium - Mg
        Song is: How Soon Is Now? by The Smiths.
        Holiday is: Bastille Day.
        SCP is: SCP-1459-J - X-Sponge.
        Album is: Slippery When Wet by Bon Jovi.
        Steak doneness: Medium Well - 4.
        Toast Doneness: done on one side.
        Hot Beverage: Bovril.
        Tea/Coffee Colour: B
        Soda is: Dr Pepper.
        Movie is: Monterey Pop.
        Programming Language is: Argus.
        Animal is: Lemur.
        Pokemon is: 724 Decidueye.
        Book is: Pride and Prejudice by Jane Austen.
------------------------------------------------
