###### Your Results Are: ######
Name: Daniele Sibyl Inoue-Scott, IV.
Citizen ID Num: A0889694447304E1
First initial: D, Last initial: I.
Gender: male. Pronouns: any.
DOB: Jul 3, 1983 - Age: 38 years.
Birthplace: Titania.
Primary Citizenship: France
Associate Citizenship(s): Ghana, Cambodia, United Kingdom, Kepler-22b, Norway, Guyana.
Star Sign: Cancer.
------------------------------------------------
Height: 91.00 cm.
Mass:  23.19 kg.
Beliefs: A‚à¥A‚à¥.
Political Party membership: Imperial British Conservative Party¬†
Relationship Status: Single. 
Children: None.
Known allergies: latex.
Blood type: A ‚Çô‚Çë·µç
You are afraid of blood.
Prexisting Health Conditions: Asthma controlled with diet & medication.
Dietary Restrictions: Pescatarian.
Hobbies: Cheesemaking and Swimming.
Languages: Deccan, Burmese, Bolak and Barsoomian.
Occupation: Aircraft Mechanic.
Security Clearance: None.
Criminal Record: Criminal Convictions on File.
Arrest Record: Arrest Record on File.
Warrants: No Active Warrants..
Networth: ¬•2566022.67.
Credit Score: 742.
Highest Education Achieved: Doctoral.
Last School Attended: University of¬†Gloucester.
------------------------------------------------
Your:
        Childhood home was on Hampden Wynd.
        First pet's name was Daisy Duke.
        Childhood best-friend's name is Liana Wood.
        First vehicle:  LaSalle.
        Mother's maiden name: Villanueva.
        Fursona: None.
        Fighting Style: Silat.
        Superpower is: Whenever you order a salad.
------------------------------------------------
Your favourite/preferred:
        Colour is: Deep saffron - #FF9933.
        Food is: Caprese Salad.
        Ice Cream is: Cappuccino Chocolate Chunk.
        Poem is: Incident - Countee Cullen.
        Flower is: African Daisy.
        Sleepwear is: t-shirt and boxer briefs.
        Homestar Runner Character: Pom Pom's girls.
        Superhero is: Batgirl.
        Social Media Network is: Habbo.
        Season is: Winter.
        Tree is: Asimina.
        Emoji is: üåà.
        Spectator Sport: Curling.
        Cryptid is: Orang Mawas.
        Simpsons Character is: Leprechaun
        Element is: Regalite
        Song is: Personal Jesus by Depeche Mode.
        Holiday is: Passover.
        SCP is: SCP-852¬†- Lunar Anomaly.
        Album is: Gold: Greatest Hits by ABBA.
        Steak doneness: Medium Well - 4.
        Toast Doneness: done on one side.
        Hot Beverage: Coffee.
        Tea/Coffee Colour: E
        Soda is: Masafi.
        Movie is: Branded to Kill.
        Programming Language is: MATLAB.
        Animal is: Snail.
        Pokemon is: 325 Spoink.
        Book is: How the Steel by Nikolai Ostrovsky.
------------------------------------------------
