###### Your Results Are: ######
Name: Vera Khadija Sahu-Akther.
Citizen ID Num: A6ECA3BA7E17EF4B
First initial: V, Last initial: S.
Gender: female. Pronouns: ey/em.
DOB: Jan 20, 1949 - Age: 72 years.
Birthplace: Fortuna¬†.
Primary Citizenship: Bahrain
Associate Citizenship(s): Nepal, Wolf 1061c.
Star Sign: Capricorn.
------------------------------------------------
Height: 107.00 cm.
Mass:  25.19 kg.
Beliefs: No strong philosophical or religious beliefs..
Political Party membership: Friends of Beer Party
Relationship Status: 5 loving partner(s). 
Children: None.
Known allergies: hair dyes.
Blood type: A ‚Çô‚Çë·µç
You are afraid of the color black.
Prexisting Health Conditions: St. Vitus' Dance controlled with diet & medication.
Dietary Restrictions: Gluten-free.
Hobbies: Watching documentaries and Knife making.
Languages: Chhattisgarhi, Damin.
Occupation: Furniture Finishers.
Security Clearance: None.
Criminal Record: No Criminal Convictions.
Arrest Record: No Arrests on File.
Warrants: No Active Warrants..
Networth: ¬•5074613.76.
Credit Score: 375.
Highest Education Achieved: Post-Doc.
Last School Attended: Capeside High.
------------------------------------------------
Your:
        Childhood home was on Milman's Street.
        First pet's name was Gucci.
        Childhood best-friend's name is Chantal Patil.
        First vehicle:  Continental.
        Mother's maiden name: Yue.
        Fursona: None.
        Fighting Style: Wing Chun.
        Superpower is: Offspring Detection.
------------------------------------------------
Your favourite/preferred:
        Colour is: Han purple - #5218FA.
        Food is: Tocino.
        Ice Cream is: Blueberry Ice Cream.
        Poem is: Jazz Fantasia - Carl Sandburg.
        Flower is: Quaker Ladies.
        Sleepwear is: vest and boxers.
        Homestar Runner Character: Bear Holding a Shark.
        Superhero is: Iron Man.
        Social Media Network is: Flixster.
        Season is: Winter.
        Tree is: Xylosoma buxifolia.
        Emoji is: ü§©.
        Spectator Sport: Skateboarding.
        Cryptid is: Mapinguari.
        Simpsons Character is: Maggie Simpson
        Element is: Radium - Ra
        Song is: Under the Boardwalk by The Drifters.
        Holiday is: Yom Kippur.
        SCP is: SCP-277¬†- Chalkland.
        Album is: Saturday Night Fever by Bee Gees.
        Steak doneness: Blue - 0.
        Toast Doneness: 2.
        Hot Beverage: Coffee.
        Tea/Coffee Colour: C
        Soda is: Inca Kola.
        Movie is: The Double Life of V√©ronique.
        Programming Language is: Snap!.
        Animal is: Anteater.
        Pokemon is: 681 Aegislash.
        Book is: How to Win Friends and Influence People by Dale Carnegie.
------------------------------------------------
