###### Your Results Are: ######
Name: Pvt. Veronica Patrick Ahamad-Imran, IV.
Citizen ID Num: 886330AF5FB3DB03
First initial: V, Last initial: A.
Gender: male. Pronouns: any.
DOB: Nov 20, 1998 - Age: 23 years.
Birthplace: Tormance¬†.
Primary Citizenship: K2-288Bb
Associate Citizenship(s): Kepler-26e, Kepler-298d, Morocco, Kepler-1552b, Burkina Faso, Mauritius.
Star Sign: Scorpio.
------------------------------------------------
Height: 203.00 cm.
Mass:  86.54 kg.
Beliefs: Zalmoxianism.
Political Party membership: Teddy Bear Alliance¬†
Relationship Status: Single. 
Children: 2 children.
Known allergies: none.
Blood type: O ‚Çô‚Çë·µç
You are afraid of people or society.
Prexisting Health Conditions: Blood Pressure controlled with diet & medication.
Dietary Restrictions: Lemba.
Hobbies: Model building.
Languages: Cebuano, Mandarin Chinese, Moss and Globish.
Occupation: Marina Boat Charter Administrator.
Security Clearance: None.
Criminal Record: No Criminal Convictions.
Arrest Record: No Arrests on File.
Warrants: No Active Warrants..
Networth: ¬•4348591.39.
Credit Score: 831.
Highest Education Achieved: Masters.
Last School Attended: Ikenfell.
------------------------------------------------
Your:
        Childhood home was on Evelyn Reach.
        First pet's name was Barbie.
        Childhood best-friend's name is Marin Lewis.
        First vehicle:  Durant.
        Mother's maiden name: Lopez.
        Fursona: Wolverine.
        Fighting Style: Glima.
        Superpower is: Never has to poop.
------------------------------------------------
Your favourite/preferred:
        Colour is: Olivine - #9AB973.
        Food is: Dark Chocolate.
        Ice Cream is: Mango Low Fat Frozen Yogurt.
        Poem is: Australia - A D Hope.
        Flower is: Meconopsis.
        Sleepwear is: vest and trousers.
        Homestar Runner Character: Humidibot.
        Superhero is: Iron Fist.
        Social Media Network is: Fillos de Galicia.
        Season is: Winter.
        Tree is: Ulmus carpinifolia.
        Emoji is: üíê.
        Spectator Sport: Curling.
        Cryptid is: Almas.
        Simpsons Character is: Nelson Muntz
        Element is: Mithril¬†/ Mythril
        Song is: Heartbreak Hotel by Elvis Presley.
        Holiday is: Father's Day.
        SCP is: SCP-1201-J¬†- That One Movie.
        Album is: Oops!... I Did It Again by Britney Spears.
        Steak doneness: Blue - 0.
        Toast Doneness: 5.
        Hot Beverage: Tea.
        Tea/Coffee Colour: B
        Soda is: Limca.
        Movie is: Unfaithfully Yours.
        Programming Language is: Modula-3.
        Animal is: Myna.
        Pokemon is: 408 Cranidos.
        Book is: Norwegian Wood by Haruki Murakami.
------------------------------------------------
