###### Your Results Are: ######
Name: Rt. Hon. Ha Maura Rasheed-Sultan.
Citizen ID Num: C0EC24C763A3DF53
First initial: H, Last initial: R.
Gender: masc. Pronouns: xe/xir.
DOB: Mar 13, 1942 - Age: 79 years.
Birthplace: VineaÂ .
Primary Citizenship: Kepler-296f
Associate Citizenship(s): Poland, Kepler-283c, Kepler-62e, Gliese 163 c.
Star Sign: Pisces.
------------------------------------------------
Height: 246.00 cm.
Mass:  175.50 kg.
Beliefs: Five-Percent Nation.
Political Party membership: Bill and Ben PartyÂ 
Relationship Status: Single. 
Children: None.
Known allergies: mould.
Blood type: A â‚šâ‚’â‚›
You are afraid of fire.
Prexisting Health Conditions: Dictionary controlled with diet & medication.
Dietary Restrictions: Vegan.
Hobbies: Rock balancing and Geocaching.
Languages: Wu Chinese, Mondial and Romulan.
Occupation: Metal Casting Machine Operator.
Security Clearance: None.
Criminal Record: No Criminal Convictions.
Arrest Record: No Arrests on File.
Warrants: No Active Warrants..
Networth: Â¥3501646.14.
Credit Score: 304.
Highest Education Achieved: Undergraduate.
Last School Attended: Will O'Wisp Academy.
------------------------------------------------
Your:
        Childhood home was on Pump Croft.
        First pet's name was Maqui.
        Childhood best-friend's name is Katarzyna Salas.
        First vehicle:  Pontiac.
        Mother's maiden name: Yue.
        Fursona: Grizzly Bear.
        Fighting Style: SpeachÃ³ireacht.
        Superpower is: Able to determine what kind of pizza is in a pizza box.
------------------------------------------------
Your favourite/preferred:
        Colour is: Dark sea green - #8FBC8F.
        Food is: Fried Dumplings.
        Ice Cream is: World's Best Vanilla No Fat Frozen Yogurt.
        Poem is: On Raglan Road - Patrick Kavanagh.
        Flower is: Osteospermum.
        Sleepwear is: t-shirt and boxers.
        Homestar Runner Character: The Robot.
        Superhero is: The Rocketeer.
        Social Media Network is: Qzone.
        Season is: Spring.
        Tree is: Schefflera glabrata[25].
        Emoji is: ðŸ’ž.
        Spectator Sport: Beach Soccer.
        Cryptid is: Mngwa.
        Simpsons Character is: Snake Jailbird
        Element is: Antidermis
        Song is: Kicks by Paul Revere & The Raiders.
        Holiday is: Rosh Hashanah.
        SCP is: SCP-1960-JÂ - Stone Sphere.
        Album is: The Score by Fugees.
        Steak doneness: Rare - 1.
        Toast Doneness: 5.
        Hot Beverage: Coffee.
        Tea/Coffee Colour: D
        Soda is: Sussex Golden.
        Movie is: Fishing with John.
        Programming Language is: dc.
        Animal is: Domestic canary.
        Pokemon is: 449 Hippopotas.
        Book is: Nineteen Eighty-Four by George Orwell.
------------------------------------------------
