###### Your Results Are: ######
Name: Prof. Sharron Fatoumata Fonseca-Hussain.
Citizen ID Num: 4BEAA290B8B6A78A
First initial: S, Last initial: F.
Gender: complicated. Pronouns: she/wif.
DOB: Jul 9, 1929 - Age: 92 years.
Birthplace: PrysmosÂ .
Primary Citizenship: Belgium
Associate Citizenship(s): Eswatini (fmr. "Swaziland"), Sudan.
Star Sign: Cancer.
------------------------------------------------
Height: 266.00 cm.
Mass:  212.27 kg.
Beliefs: Continuing Anglican movement.
Political Party membership: Bill and Ben PartyÂ 
Relationship Status: 4 loving partner(s). 
Children: None.
Known allergies: latex.
Blood type: B â‚™áµ¤â‚—â‚—
You are afraid of Halloween.
Prexisting Health Conditions: Lung Conditions controlled with diet & medication.
Dietary Restrictions: Omnivore.
Hobbies: Upcycling and Diorama.
Languages: Thai, Parallel English.
Occupation: Heavy Equipment Mechanic.
Security Clearance: None.
Criminal Record: Criminal Convictions on File.
Arrest Record: Arrest Record on File.
Warrants: No Active Warrants..
Networth: Â¥1977168.20.
Credit Score: 516.
Highest Education Achieved: Post Grad - ABD.
Last School Attended: The University.
------------------------------------------------
Your:
        Childhood home was on Flint Esplanade.
        First pet's name was Rikku.
        Childhood best-friend's name is Valerie Balde.
        First vehicle:  Elgin.
        Mother's maiden name: Cen.
        Fursona: None.
        Fighting Style: Japanese martial arts.
        Superpower is: Memorize song lyrics perfectly on the first listen.
------------------------------------------------
Your favourite/preferred:
        Colour is: Illuminating emerald - #319177.
        Food is: Tortilla Soup.
        Ice Cream is: Socialice.
        Poem is: Love's Philosophy - Percy Bysshe Shelley.
        Flower is: Delphinium.
        Sleepwear is: bra and boxers.
        Homestar Runner Character: The Paper.
        Superhero is: Green Lantern.
        Social Media Network is: Talkbiznow.
        Season is: Spring.
        Tree is: Juniperus saxicola.
        Emoji is: ðŸ™‹.
        Spectator Sport: Mixed martial arts.
        Cryptid is: Altamaha-ha.
        Simpsons Character is: Surly Duff
        Element is: Bombastium
        Song is: Get Up Stand Up by Bob Marley & The Wailers.
        Holiday is: Guy Fawkes Day.
        SCP is: SCP-642Â - Hot Springs.
        Album is: Hybrid Theory by Linkin Park.
        Steak doneness: Well Done - 5.
        Toast Doneness: 2.
        Hot Beverage: Bovril.
        Tea/Coffee Colour: B
        Soda is: KickStart.
        Movie is: The Exterminating Angel.
        Programming Language is: Dart.
        Animal is: Turtle.
        Pokemon is: 521 Unfezant.
        Book is: The Front Runner by Patricia Nell Warren.
------------------------------------------------
