###### Your Results Are: ######
Name: Admiral Ling Lihong Xin-Blanco.
Citizen ID Num: B987BD2DD1F7D534
First initial: L, Last initial: X.
Gender: nonbinary. Pronouns: she/they.
DOB: Sep 12, 2003 - Age: 18 years.
Birthplace: Gehenna .
Primary Citizenship: Timor-Leste
Associate Citizenship(s): Colombia, South Sudan, Kazakhstan, Kepler-705b, France.
Star Sign: Virgo.
------------------------------------------------
Height: 113.00 cm.
Mass:  25.54 kg.
Beliefs: No strong philosophical or religious beliefs..
Political Party membership: No Party to Support
Relationship Status: Single. 
Children: None.
Known allergies: detergents.
Blood type: B ₙᵤₗₗ
You are afraid of bacteria.
Prexisting Health Conditions: Depression controlled with diet & medication.
Dietary Restrictions: Ketogenic.
Hobbies: Storytelling and Card games.
Languages: Czech, Gan Chinese, Special English.
Occupation: Air Crew Officer.
Security Clearance: None.
Criminal Record: No Criminal Convictions.
Arrest Record: No Arrests on File.
Warrants: No Active Warrants..
Networth: ¥5317370.61.
Credit Score: 343.
Highest Education Achieved: Primary School.
Last School Attended: The University of Bums on Seats.
------------------------------------------------
Your:
        Childhood home was on Lowther West.
        First pet's name was Bella Hutchison Neasbitt.
        Childhood best-friend's name is Sima Kouassi.
        First vehicle:  Packard.
        Mother's maiden name: Bennett.
        Fursona: None.
        Fighting Style: Suntukan.
        Superpower is: Communing with squirrels.
------------------------------------------------
Your favourite/preferred:
        Colour is: Green (web) - #008000.
        Food is: Gyro Sandwhich.
        Ice Cream is: Bananas on the Rum.
        Poem is: There Is Pleasure In The Pathless Woods - George Gordon Byron.
        Flower is: Queen Anne’s Lace.
        Sleepwear is: boxer briefs.
        Homestar Runner Character: Tire.
        Superhero is: Doc Savage.
        Social Media Network is: Chess.com.
        Season is: Spring.
        Tree is: European Hornbeam (Carpinus betulus; southern Great Britain only).
        Emoji is: ✋.
        Spectator Sport: Darts.
        Cryptid is: Chessie.
        Simpsons Character is: Kirk Van Houten
        Element is: Fluorine - F
        Song is: Tumbling Dice by The Rolling Stones.
        Holiday is: New Year.
        SCP is: SCP-865 - The Gentleman's Lash.
        Album is: Legend: The Best of Bob Marley & The Wailers by Bob Marley & The Wailers.
        Steak doneness: Blue - 0.
        Toast Doneness: Burnt - 6.
        Hot Beverage: Coffee.
        Tea/Coffee Colour: Black - A
        Soda is: Sprite Ice.
        Movie is: El Norte.
        Programming Language is: Flex.
        Animal is: Shrew.
        Pokemon is: 271 Lombre.
        Book is: The Diary Of Anne Frank by Anne Frank.
------------------------------------------------
