###### Your Results Are: ######
Name: Wendolyn Wilbur Bao-AntÃ³nio, V.
Citizen ID Num: 6B94E193F90B4DC9
First initial: W, Last initial: B.
Gender: femme. Pronouns: he/were.
DOB: Jul 21, 1921 - Age: 100 years.
Birthplace: Mist Flow.
Primary Citizenship: Grenada
Associate Citizenship(s): Wolf 1061c, TRAPPIST-1e, Chile, Montenegro, Kepler-298d, Burundi, Norway.
Star Sign: Cancer.
------------------------------------------------
Height: 75.00 cm.
Mass:  16.31 kg.
Beliefs: No strong philosophical or religious beliefs..
Political Party membership: Canadian Extreme Wrestling Party
Relationship Status: 4 loving partner(s). 
Children: None.
Known allergies: none.
Blood type: B â‚šâ‚’â‚›
You are afraid of darkness.
Prexisting Health Conditions: Arthritis controlled with diet & medication.
Dietary Restrictions: Pescatarian.
Hobbies: Auto detailing and Perfume.
Languages: Burmese, Marathi, Enochian and Khuzdul.
Occupation: Insurance Policy Processing Clerk.
Security Clearance: None.
Criminal Record: No Criminal Convictions.
Arrest Record: No Arrests on File.
Warrants: No Active Warrants..
Networth: Â¥2759272.80.
Credit Score: 534.
Highest Education Achieved: Post-Doc.
Last School Attended: Pennbrook University.
------------------------------------------------
Your:
        Childhood home was on Jackson Wharf.
        First pet's name was Steve McQueen.
        Childhood best-friend's name is Madina Banerjee.
        First vehicle:  Vauxhall.
        Mother's maiden name: Duan.
        Fursona: None.
        Fighting Style: Bultong.
        Superpower is: Superpowered Mood Swings.
------------------------------------------------
Your favourite/preferred:
        Colour is: Dark cyan - #008B8B.
        Food is: Peach Tea.
        Ice Cream is: Honey Vanilla.
        Poem is: A Silly Poem - Spike Milligan.
        Flower is: Dill.
        Sleepwear is: boxers.
        Homestar Runner Character: Old Man Rootbeer.
        Superhero is: Hellboy.
        Social Media Network is: Plurk.
        Season is: Autumn.
        Tree is: Crescentia.
        Emoji is: ðŸ˜†.
        Spectator Sport: F1 Grand Prix.
        Cryptid is: Ebu gogo.
        Simpsons Character is: Apu Nahasapeemapetilon
        Element is: Metal X (Rovolon)
        Song is: Sweet Home Alabama by Lynyrd Skynyrd.
        Holiday is: Passover.
        SCP is: SCP-708Â - The Big Orange Forklift.
        Album is: Born in the U.S.A. by Bruce Springsteen.
        Steak doneness: Medium - 3.
        Toast Doneness: 2.
        Hot Beverage: Monster.
        Tea/Coffee Colour: B
        Soda is: Coca-Cola C2.
        Movie is: Meantime.
        Programming Language is: Ace DASL (Distributed Application Specification Language).
        Animal is: Seahorse.
        Pokemon is: 841 Flapple.
        Book is: The Diary Of Anne Frank by Anne Frank.
------------------------------------------------
