###### Your Results Are: ######
Name: General Giovanni Weidong Min-Calderon, Jr..
Citizen ID Num: 1ED761E0E6174C96
First initial: G, Last initial: M.
Gender: nonbinary. Pronouns: ey/em.
DOB: Sep 13, 1910 - Age: 111 years.
Birthplace: Tranai¬†.
Primary Citizenship: Ethiopia
Associate Citizenship(s): Greece, Comoros, Georgia, Belarus.
Star Sign: Virgo.
------------------------------------------------
Height: 119.00 cm.
Mass:  25.49 kg.
Beliefs: No strong philosophical or religious beliefs..
Political Party membership: Best Party
Relationship Status: 1 loving partner(s). 
Children: 1 children.
Known allergies: none.
Blood type: O ‚Çö‚Çí‚Çõ
You are afraid of the moon.
Prexisting Health Conditions: Hearing Problems controlled with diet & medication.
Dietary Restrictions: Pescatarian.
Hobbies: Sculpting and Sports memorabilia.
Languages: North Levantine Arabic, Malayalam, Pakuni and Afrihili.
Occupation: Industrial Air Pollution Analyst.
Security Clearance: None.
Criminal Record: Criminal Convictions on File.
Arrest Record: Arrest Record on File.
Warrants: No Active Warrants..
Networth: ¬•4782381.40.
Credit Score: 643.
Highest Education Achieved: Post-Graduate.
Last School Attended: The University.
------------------------------------------------
Your:
        Childhood home was on Shirley Oak.
        First pet's name was Eve.
        Childhood best-friend's name is Xing Fu.
        First vehicle:  Hennessey.
        Mother's maiden name: Prasad.
        Fursona: None.
        Fighting Style: Gendai bud≈ç.
        Superpower is: Rainbow Generation.
------------------------------------------------
Your favourite/preferred:
        Colour is: Blue-violet (Crayola) - #7366BD.
        Food is: Cherry Limeade.
        Ice Cream is: Chocolate Raspberry Fudge Swirl.
        Poem is: Love's Philosophy - Percy Bysshe Shelley.
        Flower is: Wedelia.
        Sleepwear is: panties.
        Homestar Runner Character: Stooly.
        Superhero is: Hawkeye.
        Social Media Network is: Netlog.
        Season is: Summer.
        Tree is: Zanthoxylum martinicense.
        Emoji is: üíÉ.
        Spectator Sport: Cricket.
        Cryptid is: Ebu gogo.
        Simpsons Character is: Comic Book Guy
        Element is: Ice-nine
        Song is: Suspicious Minds by Elvis Presley.
        Holiday is: Rosh Hashanah.
        SCP is: SCP-176¬†- Observable Time Loop.
        Album is: Wish You Were Here by Pink Floyd.
        Steak doneness: Medium Well - 4.
        Toast Doneness: White - 0.
        Hot Beverage: Earl Grey, hot.
        Tea/Coffee Colour: White - F
        Soda is: Pepsi Perfect.
        Movie is: Man Push Cart.
        Programming Language is: Arc.
        Animal is: Trapdoor spider.
        Pokemon is: 709 Trevenant.
        Book is: The Name of the Rose by Umberto Eco.
------------------------------------------------
