###### Your Results Are: ######
Name: Ensign Kyaw Francesco Islam-Jena.
Citizen ID Num: 778A3C8C5EBF8A1B
First initial: K, Last initial: I.
Gender: masc. Pronouns: ey/em.
DOB: May 30, 1923 - Age: 98 years.
Birthplace: Canopus III.
Primary Citizenship: Mongolia
Associate Citizenship(s): TOI 700 d, Kepler-1229b, Myanmar (formerly Burma), Portugal.
Star Sign: Gemini.
------------------------------------------------
Height: 266.00 cm.
Mass:  183.97 kg.
Beliefs: No strong philosophical or religious beliefs..
Political Party membership: Royalist Party of Estonia
Relationship Status: 3 loving partner(s). 
Children: 3 children.
Known allergies: none.
Blood type: O ₙₑᵍ
You are afraid of dirt and germs.
Prexisting Health Conditions: Allergies controlled with diet & medication.
Dietary Restrictions: Words of Wisom.
Hobbies: Pressed flower craft and Music.
Languages: Czech, Barsoomian.
Occupation: Legislative Assistant.
Security Clearance: None.
Criminal Record: Criminal Convictions on File.
Arrest Record: Arrest Record on File.
Warrants: No Active Warrants..
Networth: ¥4134524.81.
Credit Score: 321.
Professional Assn: Doctor of Medicine
Highest Education Achieved: Undergraduate.
Last School Attended: University of Bantshire.
------------------------------------------------
Your:
        Childhood home was on Baron Acres.
        First pet's name was Leward.
        Childhood best-friend's name is Jenee Watt.
        First vehicle:  Star.
        Mother's maiden name: Gil.
        Fursona: Fox/Rabbit.
        Fighting Style: Shaolin Kung Fu.
        Superpower is: Superpowered Mood Swings.
------------------------------------------------
Your favourite/preferred:
        Colour is: Blue-gray - #6699CC.
        Food is: Croque Monsieur.
        Ice Cream is: Chocolate Peanut Butter Cookie Dough.
        Poem is: Not Waving but Drowning - Stevie Smith.
        Flower is: Deutzia.
        Sleepwear is: bra and trousers.
        Homestar Runner Character: Tandy 400.
        Superhero is: Elektra.
        Social Media Network is: WriteAPrisoner.com.
        Season is: Summer.
        Tree is: Rhamnaceae.
        Emoji is: ⭐.
        Spectator Sport: Baseball.
        Cryptid is: Cadborosaurus.
        Simpsons Character is: Santa's Little Helper
        Element is: Transformium
        Song is: Iron Man by Black Sabbath.
        Holiday is: Ramadan.
        SCP is: SCP-976 - Anomalous Hard Drive.
        Album is: The Miseducation of Lauryn Hill by Lauryn Hill.
        Steak doneness: Blue - 0.
        Toast Doneness: 3.
        Hot Beverage: Tea.
        Tea/Coffee Colour: White - F
        Soda is: Monster Energy.
        Movie is: The Kid.
        Programming Language is: Visual DialogScript.
        Animal is: Wolverine.
        Pokemon is: 326 Grumpig.
        Book is: The Very Hungry Caterpillar by Eric Carle.
------------------------------------------------
