###### Your Results Are: ######
Name: Lcpl Liying Scott Thomson-Ren, CVA[30].
Citizen ID Num: 4BA067F4C2F422A1
First initial: L, Last initial: T.
Gender: femme. Pronouns: she/they.
DOB: Oct 6, 1959 - Age: 62 years.
Birthplace: RiverworldÂ .
Primary Citizenship: El Salvador
Associate Citizenship(s): CÃ´te d'Ivoire, Malta, Nepal, Somalia, Vanuatu, Trinidad and Tobago, Russia.
Star Sign: Libra.
------------------------------------------------
Height: 227.00 cm.
Mass:  92.75 kg.
Beliefs: Other.
Political Party membership: The Party Party
Relationship Status: 7 loving partner(s). 
Children: None.
Known allergies: latex.
Blood type: O â‚™áµ¤â‚—â‚—
You are afraid of buttons.
Prexisting Health Conditions: UTI controlled with diet & medication.
Dietary Restrictions: Words of Wisom.
Hobbies: Inline skating.
Languages: Amharic, Dothraki.
Occupation: Animal Trainer.
Security Clearance: None.
Criminal Record: Criminal Convictions on File.
Arrest Record: Arrest Record on File.
Warrants: No Active Warrants..
Networth: Â¥3745077.95.
Credit Score: 395.
Professional Assn: Licensed Professional Soil Scientist, or similar
Highest Education Achieved: Post Grad - ABD.
Last School Attended: West Beverly Hilly High.
------------------------------------------------
Your:
        Childhood home was on Mackintosh Close.
        First pet's name was Owen Beck.
        Childhood best-friend's name is Juana Trinh.
        First vehicle:  Morris.
        Mother's maiden name: Bruce.
        Fursona: None.
        Fighting Style: Wrestling.
        Superpower is: Can turn hamburgers into pocket lint.
------------------------------------------------
Your favourite/preferred:
        Colour is: Cerulean - #007BA7.
        Food is: Beef Stroganoff.
        Ice Cream is: Sugar Plum.
        Poem is: Sailor Town - Cicely Fox Smith.
        Flower is: Rock Rose.
        Sleepwear is: boxers.
        Homestar Runner Character: Lotionman.
        Superhero is: Ant-Man.
        Social Media Network is: The Student Room.
        Season is: Spring.
        Tree is: Tabebuia rosea.
        Emoji is: ðŸ˜•.
        Spectator Sport: Netball.
        Cryptid is: Chessie.
        Simpsons Character is: The Rich Texan
        Element is: Tennessine - Ts
        Song is: Say It Loud (I'm Back And I'm Proud) by James Brown.
        Holiday is: Valentine's Day.
        SCP is: SCP-775Â - Hungry Ticks.
        Album is: Tapestry by Carole King.
        Steak doneness: Well Done - 5.
        Toast Doneness: White - 0.
        Hot Beverage: Bovril.
        Tea/Coffee Colour: B
        Soda is: Tab Energy.
        Movie is: I fidanzati.
        Programming Language is: Tea.
        Animal is: Spoonbill.
        Pokemon is: 892 Urshifu.
        Book is: The Grapes of Wrath by John Steinbeck.
------------------------------------------------
