###### Your Results Are: ######
Name: Ernesto Elsa Cheng-Pathan, Esq..
Citizen ID Num: 3A6099C4C2EE496E
First initial: E, Last initial: C.
Gender: nonbinary. Pronouns: they/them.
DOB: Jan 11, 1920 - Age: 101 years.
Birthplace: Gliese 581c.
Primary Citizenship: Tau Ceti f
Associate Citizenship(s): ['None'].
Star Sign: Capricorn.
------------------------------------------------
Height: 168.00 cm.
Mass:  53.63 kg.
Beliefs: Transcendental Meditation.
Political Party membership: Deadly Serious Party
Relationship Status: 3 loving partner(s). 
Children: None.
Known allergies: mould.
Blood type: AB ‚Çô‚Çë·µç
You are afraid of ugliness.
Prexisting Health Conditions: Oral Health Issues controlled with diet & medication.
Dietary Restrictions: Vegetarian.
Hobbies: Flying.
Languages: Hungarian, Southern Pashto, Babm.
Occupation: Vocational Education Instructors College.
Security Clearance: None.
Criminal Record: No Criminal Convictions.
Arrest Record: No Arrests on File.
Warrants: No Active Warrants..
Networth: ¬•4918676.25.
Credit Score: 389.
Professional Assn: Fraternal Insurance Counselor Fellow
Highest Education Achieved: Primary School.
Last School Attended: University of Edgestow.
------------------------------------------------
Your:
        Childhood home was on Lapwing Parade.
        First pet's name was Ketchup.
        Childhood best-friend's name is Hilma Taylor.
        First vehicle:  Sterling Trucks.
        Mother's maiden name: Salam.
        Fursona: Hedgehog.
        Fighting Style: Suntukan.
        Superpower is: Sliding.
------------------------------------------------
Your favourite/preferred:
        Colour is: Arylide yellow - #E9D66B.
        Food is: Carbonara.
        Ice Cream is: Passion Fruit Smooch.
        Poem is: i like my body when it is with your - E.e. cummings.
        Flower is: Photinia.
        Sleepwear is: t-shirt.
        Homestar Runner Character: Multi-Function Dragon.
        Superhero is: Batgirl.
        Social Media Network is: Netlog.
        Season is: Winter.
        Tree is: Rollinia exsucca[2].
        Emoji is: üåà.
        Spectator Sport: Mixed martial arts.
        Cryptid is: Manipogo.
        Simpsons Character is: Dr. Nick Riviera
        Element is: Red Mercury - ??
        Song is: 96 Tears by ? & The Mysterians.
        Holiday is: Father's Day.
        SCP is: SCP-675¬†- Shadows Through the Window.
        Album is: Jagged Little Pill by Alanis Morissette.
        Steak doneness: Medium Rare - 2.
        Toast Doneness: 2.
        Hot Beverage: Bovril.
        Tea/Coffee Colour: E
        Soda is: Sprite Ice.
        Movie is: The Long Good Friday.
        Programming Language is: Groovy (programming language)|Groovy (Apache Groovy).
        Animal is: Quail.
        Pokemon is: 257 Blaziken.
        Book is: She: A History of Adventure by H. Rider Haggard.
------------------------------------------------
