###### Your Results Are: ######
Name: Rt. Hon. David Luis Aziz-Paswan.
Citizen ID Num: 0D06510B08E7AAFB
First initial: D, Last initial: A.
Gender: female. Pronouns: she/her.
DOB: Oct 20, 1918 - Age: 103 years.
Birthplace: Ceti Alpha V.
Primary Citizenship: Zimbabwe
Associate Citizenship(s): Gliese 667 Cc, South Korea, Kepler-1649c, K2-9b, Gliese 3293 d.
Star Sign: Libra.
------------------------------------------------
Height: 181.00 cm.
Mass:  65.52 kg.
Beliefs: CandomblÃ© Bantu.
Political Party membership: Donald Duck Party
Relationship Status: Single. 
Children: 1 children.
Known allergies: none.
Blood type: B â‚™áµ¤â‚—â‚—
You are afraid of women.
Prexisting Health Conditions: Skin Condition controlled with diet & medication.
Dietary Restrictions: Words of Wisom.
Hobbies: Horseshoes and Watching documentaries.
Languages: Eastern Punjabi, Saraiki, Unnamed language.
Occupation: Registrar Administrator.
Security Clearance: None.
Criminal Record: No Criminal Convictions.
Arrest Record: No Arrests on File.
Warrants: No Active Warrants..
Networth: Â¥519519.20.
Credit Score: 770.
Professional Assn: Certified Hospitality Administrator
Highest Education Achieved: Doctoral.
Last School Attended: The Academy of Unseen Arts.
------------------------------------------------
Your:
        Childhood home was on Bryony Lanes.
        First pet's name was Cloud.
        Childhood best-friend's name is Henry Hoang.
        First vehicle:  Nikola Motor.
        Mother's maiden name: Anderson.
        Fursona: Sloth.
        Fighting Style: Crossada.
        Superpower is: Can change the tv channel with you mind.
------------------------------------------------
Your favourite/preferred:
        Colour is: Cyber grape - #58427C.
        Food is: Fish and chips.
        Ice Cream is: Licorice.
        Poem is: The Cremation of Sam McGee - Robert W Service.
        Flower is: Columbine.
        Sleepwear is: t-shirt and boxer briefs.
        Homestar Runner Character: Painting of a Guy with a Big Knife.
        Superhero is: Superman.
        Social Media Network is: Yahoo! 360Â°.
        Season is: Winter.
        Tree is: Cecropia.
        Emoji is: ðŸŽ‰.
        Spectator Sport: Greyhound Racing.
        Cryptid is: Mongolian death worm.
        Simpsons Character is: Gil Gunderson
        Element is: Arenak
        Song is: Free Fallin' by Tom Petty and The Heartbreakers.
        Holiday is: Rosh Hashanah.
        SCP is: SCP-174Â - Ventriloquist's Dummy.
        Album is: Falling into You by Celine Dion.
        Steak doneness: Medium - 3.
        Toast Doneness: 2.
        Hot Beverage: Earl Grey, hot.
        Tea/Coffee Colour: White - F
        Soda is: Coca-Cola Orange Vanilla.
        Movie is: Crash.
        Programming Language is: PL/IÂ â€“ ISO 6160.
        Animal is: Gull.
        Pokemon is: 648 Meloetta.
        Book is: The Book Thief by Markus Zusak.
------------------------------------------------
