###### Your Results Are: ######
Name: Xiaoli Agus Khan-Karmakar, IV.
Citizen ID Num: 72982ECC4C8B43FB
First initial: X, Last initial: K.
Gender: femme. Pronouns: he/were.
DOB: Oct 7, 1969 - Age: 52 years.
Birthplace: Oa the Living PlanetÂ .
Primary Citizenship: Tuvalu
Associate Citizenship(s): Tajikistan, Czechia (Czech Republic), Comoros, Togo, TRAPPIST-1f.
Star Sign: Libra.
------------------------------------------------
Height: 168.00 cm.
Mass:  56.45 kg.
Beliefs: No strong philosophical or religious beliefs..
Political Party membership: Beer Lovers Party
Relationship Status: 7 loving partner(s). 
Children: None.
Known allergies: grass and tree pollen.
Blood type: A â‚šâ‚’â‚›
You are afraid of knees.
Prexisting Health Conditions: Depression controlled with diet & medication.
Dietary Restrictions: Halal.
Hobbies: Microbiology.
Languages: Mesopotamian Arabic, Newspeak and Romanid.
Occupation: Personnel Administrator.
Security Clearance: None.
Criminal Record: Criminal Convictions on File.
Arrest Record: Arrest Record on File.
Warrants: No Active Warrants..
Networth: Â¥4978083.10.
Credit Score: 368.
Professional Assn: Certified Wedding and Event Planner
Highest Education Achieved: Post-Graduate.
Last School Attended: Bayside High.
------------------------------------------------
Your:
        Childhood home was on Willow Boulevard.
        First pet's name was Jesse Mae.
        Childhood best-friend's name is Saraswati Munro.
        First vehicle:  Kline Kar.
        Mother's maiden name: Yadav.
        Fursona: Red Fox.
        Fighting Style: Bangladeshi martial arts.
        Superpower is: Invisibility. Does not apply to clothes.
------------------------------------------------
Your favourite/preferred:
        Colour is: Light goldenrod yellow - #FAFAD2.
        Food is: Mole.
        Ice Cream is: Sweet Cream & Cookies Low Fat Ice Cream.
        Poem is: The Crunch - Charles Bukowski.
        Flower is: Whirling Butterflies.
        Sleepwear is: t-shirt and panties.
        Homestar Runner Character: Dolph Hauldhagen.
        Superhero is: Batwoman.
        Social Media Network is: LinkExpats.
        Season is: Summer.
        Tree is: Juglans major.
        Emoji is: ðŸ’¦.
        Spectator Sport: Darts.
        Cryptid is: Mokele-mbembe.
        Simpsons Character is: Luann Van Houten
        Element is: Lutetium - Lu
        Song is: Don't Let Me Be Misunderstood by The Animals.
        Holiday is: Yom Kippur.
        SCP is: SCP-350Â - Unbreakable Contract.
        Album is: Cross Road by Bon Jovi.
        Steak doneness: Blue - 0.
        Toast Doneness: 2.
        Hot Beverage: Earl Grey, hot.
        Tea/Coffee Colour: C
        Soda is: orange blaze.
        Movie is: Parasite.
        Programming Language is: POV-Ray SDL.
        Animal is: Salmon.
        Pokemon is: 540 Sewaddle.
        Book is: The Hite Report by Shere Hite.
------------------------------------------------
