###### Your Results Are: ######
Name: Dilip Kelle Koffi-Xue.
Citizen ID Num: 0A97386C5064DC98
First initial: D, Last initial: K.
Gender: masc. Pronouns: she/wif.
DOB: Jan 30, 1983 - Age: 38 years.
Birthplace: Korhal.
Primary Citizenship: Australia
Associate Citizenship(s): ['None'].
Star Sign: Aquarius.
------------------------------------------------
Height: 72.00 cm.
Mass:  9.33 kg.
Beliefs: No strong philosophical or religious beliefs..
Political Party membership: Fancy Dress PartyÂ 
Relationship Status: 6 loving partner(s). 
Children: 1 children.
Known allergies: none.
Blood type: B â‚™áµ¤â‚—â‚—
You are afraid of fire.
Prexisting Health Conditions: Allergies controlled with diet & medication.
Dietary Restrictions: Vegetarian.
Hobbies: Electronics and Cue sports.
Languages: Sanaani Spoken Arabic, Dutch, Brithenig and Esperanto II.
Occupation: Music Teacher.
Security Clearance: None.
Criminal Record: No Criminal Convictions.
Arrest Record: No Arrests on File.
Warrants: No Active Warrants..
Networth: Â¥5722219.88.
Credit Score: 428.
Professional Assn: Decision & Risk Management Professional
Highest Education Achieved: Secondary School.
Last School Attended: Dartmouth University.
------------------------------------------------
Your:
        Childhood home was on Lynn Piece.
        First pet's name was Oliver Johnson.
        Childhood best-friend's name is Lashon Zhuang.
        First vehicle:  Mercury.
        Mother's maiden name: Jahan.
        Fursona: Absol.
        Fighting Style: Malaysia.
        Superpower is: Can make the sound of a tree falling in the forest with no one to hear it.
------------------------------------------------
Your favourite/preferred:
        Colour is: Gamboge - #E49B0F.
        Food is: Mole.
        Ice Cream is: Strawberry Rhubarb Low Fat Frozen Yogurt.
        Poem is: When I Love - Nizar Qabbani.
        Flower is: Trollius.
        Sleepwear is: t-shirt and boxer briefs.
        Homestar Runner Character: Bad Graphics Ghost.
        Superhero is: The Avengers.
        Social Media Network is: Fotki.
        Season is: Spring.
        Tree is: Teak (Tectona grandis).
        Emoji is: ðŸ˜£.
        Spectator Sport: MMA.
        Cryptid is: Chuchunya.
        Simpsons Character is: Dr. Julius Hibbert
        Element is: Harbenite
        Song is: A Hard Day's Night by The Beatles.
        Holiday is: Bastille Day.
        SCP is: SCP-999-JÂ - Creepy Speedo Man.
        Album is: Legend: The Best of Bob Marley & The Wailers by Bob MarleyÂ & The Wailers.
        Steak doneness: Shoe Leather - 6.
        Toast Doneness: 3.
        Hot Beverage: Monster.
        Tea/Coffee Colour: E
        Soda is: Bludwine / Budwine.
        Movie is: Fishing with John.
        Programming Language is: MaxScriptÂ internal language 3D Studio Max.
        Animal is: Locust.
        Pokemon is: 268 Cascoon.
        Book is: The Girl on the Train by Paula Hawkins.
------------------------------------------------
