###### Your Results Are: ######
Name: Col. Svetlana Florencio Qiu-Bekele, II.
Citizen ID Num: C9A675DF3BD8B9D2
First initial: S, Last initial: Q.
Gender: female. Pronouns: xe/xir.
DOB: Mar 18, 1912 - Age: 109 years.
Birthplace: the ISS.
Primary Citizenship: Russia
Associate Citizenship(s): Albania, Netherlands.
Star Sign: Pisces.
------------------------------------------------
Height: 188.00 cm.
Mass:  113.10 kg.
Beliefs: No strong philosophical or religious beliefs..
Political Party membership: OWL Party
Relationship Status: Single. 
Children: 3 children.
Known allergies: detergents.
Blood type: B ‚Çô‚Çë·µç
You are afraid of thunder and lightning.
Prexisting Health Conditions: Digestion controlled with diet & medication.
Dietary Restrictions: Kosher.
Hobbies: Puzzles.
Languages: Sindhi, Babm and Latino sine Flexione.
Occupation: Respiratory Care Technician.
Security Clearance: None.
Criminal Record: No Criminal Convictions.
Arrest Record: No Arrests on File.
Warrants: No Active Warrants..
Networth: ¬•2129668.61.
Credit Score: 636.
Professional Assn: Master of Theological Studies
Highest Education Achieved: Primary School.
Last School Attended: The University.
------------------------------------------------
Your:
        Childhood home was on Clumber Terrace.
        First pet's name was Elvira.
        Childhood best-friend's name is Cori Usman.
        First vehicle:  Autocar.
        Mother's maiden name: Muhammad.
        Fursona: Mexican.
        Fighting Style: Tewhatewha.
        Superpower is: Can fart any smell you want.
------------------------------------------------
Your favourite/preferred:
        Colour is: Light French beige - #C8AD7F.
        Food is: Italian Soda.
        Ice Cream is: Rachel's Brownie.
        Poem is: What The Motorcycle Said - Mona Van Duyn.
        Flower is: Bottlebrush.
        Sleepwear is: t-shirt and trousers.
        Homestar Runner Character: Credenza.
        Superhero is: The Rocketeer.
        Social Media Network is: Elixio.
        Season is: Autumn.
        Tree is: Afrocarpus falcatus.
        Emoji is: üëá.
        Spectator Sport: Badminton.
        Cryptid is: Kusshii.
        Simpsons Character is: Barney Gumble
        Element is: Astatine - At
        Song is: Come Together by The Beatles.
        Holiday is: Chinese New Year.
        SCP is: SCP-016¬†- Sentient Micro-Organism.
        Album is: The Eminem Show by Eminem.
        Steak doneness: Rare - 1.
        Toast Doneness: 3.
        Hot Beverage: Coffee.
        Tea/Coffee Colour: E
        Soda is: Pepsi.
        Movie is: The Soft Skin.
        Programming Language is: XL.
        Animal is: Spider¬†¬†.
        Pokemon is: 365 Walrein.
        Book is: Anna Karenina by Leo Tolstoy.
------------------------------------------------
