###### Your Results Are: ######
Name: Inocencia Henry Parveen-Fei, Sr., CP-C.
Citizen ID Num: 97178D30761164C4
First initial: I, Last initial: P.
Gender: complicated. Pronouns: they/them.
DOB: Jun 11, 1926 - Age: 95 years.
Birthplace: HD 28185b.
Primary Citizenship: Kepler-1649c
Associate Citizenship(s): San Marino, Egypt, Mozambique, Namibia.
Star Sign: Gemini.
------------------------------------------------
Height: 154.00 cm.
Mass:  49.80 kg.
Beliefs: No strong philosophical or religious beliefs..
Political Party membership: Partido del Karma DemocrÃ¡tico
Relationship Status: Single. 
Children: None.
Known allergies: none.
Blood type: AB â‚šâ‚’â‚›
You are afraid of needles/injections.
Prexisting Health Conditions: Gluten sensitivity controlled with diet & medication.
Dietary Restrictions: Fruititarian.
Hobbies: Yoga.
Languages: Sudanese Arabic, Ro.
Occupation: Computer Customer Support Specialist.
Security Clearance: None.
Criminal Record: No Criminal Convictions.
Arrest Record: No Arrests on File.
Warrants: No Active Warrants..
Networth: Â¥5312721.06.
Credit Score: 642.
Professional Assn: Chartered Management Consultant
Highest Education Achieved: Post-Doc.
Last School Attended: Starfleet Academy.
------------------------------------------------
Your:
        Childhood home was on Magnolia Cliff.
        First pet's name was Whistler.
        Childhood best-friend's name is Bernadette Khalaf.
        First vehicle:  Premier.
        Mother's maiden name: Mondal.
        Fursona: Panther.
        Fighting Style: Feng Shou.
        Superpower is: Can forsee the future.
------------------------------------------------
Your favourite/preferred:
        Colour is: Crimson (UA) - #9E1B32.
        Food is: Bagel and Lox.
        Ice Cream is: Peach.
        Poem is: Auguries of Innocence - William Blake.
        Flower is: Polyanthus.
        Sleepwear is: bra and panties.
        Homestar Runner Character: Coach Z.
        Superhero is: Marvelman.
        Social Media Network is: GemStone IV.
        Season is: Spring.
        Tree is: Ulmus carpinifolia.
        Emoji is: ðŸŒ¸.
        Spectator Sport: Basketball.
        Cryptid is: St. Johns River Monster.
        Simpsons Character is: Eddie
        Element is: Jumbonium
        Song is: Spoonful by Howlin' Wolf.
        Holiday is: Islamic Holidays.
        SCP is: SCP-880Â - Trapped Winter.
        Album is: Their Greatest Hits (1971â€“1975) by Eagles.
        Steak doneness: Rare - 1.
        Toast Doneness: 3.
        Hot Beverage: Monster.
        Tea/Coffee Colour: Black - A
        Soda is: Pocari Sweat.
        Movie is: I.
        Programming Language is: XL.
        Animal is: African buffalo.
        Pokemon is: 568 Trubbish.
        Book is: Where the Wild Things Are by Maurice Sendak.
------------------------------------------------
