###### Your Results Are: ######
Name: Zhiming Victor Phyo-Arif.
Citizen ID Num: C9CE0BCEF8424369
First initial: Z, Last initial: P.
Gender: femme. Pronouns: xe/xir.
DOB: Sep 12, 1982 - Age: 39 years.
Birthplace: RylosÂ .
Primary Citizenship: Grenada
Associate Citizenship(s): Israel, Singapore, Tau Ceti f, Luyten b.
Star Sign: Virgo.
------------------------------------------------
Height: 186.00 cm.
Mass:  110.71 kg.
Beliefs: No strong philosophical or religious beliefs..
Political Party membership: Straight Talking American Government PartyÂ (STAG) 
Relationship Status: Single. 
Children: None.
Known allergies: animal dander.
Blood type: O â‚šâ‚’â‚›
You are afraid of dentists.
Prexisting Health Conditions: Men's Health Issues controlled with diet & medication.
Dietary Restrictions: Vegetarian.
Hobbies: Kabaddi and Meteorology.
Languages: Turkish, Goa'uld and Damin.
Occupation: Border Patrol Agent.
Security Clearance: None.
Criminal Record: Criminal Convictions on File.
Arrest Record: Arrest Record on File.
Warrants: No Active Warrants..
Networth: Â¥5553337.55.
Credit Score: 360.
Professional Assn: Credentialed Manager
Highest Education Achieved: Masters.
Last School Attended: University ofÂ Gloucester.
------------------------------------------------
Your:
        Childhood home was on Airport Approach Road.
        First pet's name was Sammy Nitka.
        Childhood best-friend's name is Xiaoming Yi.
        First vehicle:  Hupp-Yeats.
        Mother's maiden name: Bhagat.
        Fursona: None.
        Fighting Style: Hung Fut.
        Superpower is: Turns every container of orange juice you touch into "Oops.
------------------------------------------------
Your favourite/preferred:
        Colour is: Gold (metallic) - #D4AF37.
        Food is: Chicken Parmigana.
        Ice Cream is: Raspberry Chocolate Chunk.
        Poem is: Mcmxiv - Philip Larkin   #20.
        Flower is: Poppy.
        Sleepwear is: t-shirt.
        Homestar Runner Character: Gel-arshie.
        Superhero is: Captain Marvel.
        Social Media Network is: Github.
        Season is: Autumn.
        Tree is: Rhizophora mangle.
        Emoji is: ðŸ’ž.
        Spectator Sport: Gymnastics.
        Cryptid is: Nahuelito.
        Simpsons Character is: Disco Stu
        Element is: Uranium - U
        Song is: Dancing Barefoot by Patty Smyth.
        Holiday is: Veterans Day.
        SCP is: SCP-314Â - Motion-Seeking Blade.
        Album is: Falling into You by Celine Dion.
        Steak doneness: Medium Rare - 2.
        Toast Doneness: 3.
        Hot Beverage: Coffee.
        Tea/Coffee Colour: C
        Soda is: Coca-Cola Life.
        Movie is: Cul-de-sac.
        Programming Language is: Fortress.
        Animal is: Roadrunner.
        Pokemon is: 778 Mimikyu.
        Book is: The Lost Symbol by Dan Brown.
------------------------------------------------
