###### Your Results Are: ######
Name: Clint Nan Hadi-Thompson, III, CDAL.
Citizen ID Num: E5D688B2983080E1
First initial: C, Last initial: H.
Gender: none. Pronouns: ey/em.
DOB: Feb 24, 1977 - Age: 44 years.
Birthplace: ThorÂ .
Primary Citizenship: Grenada
Associate Citizenship(s): ['None'].
Star Sign: Pisces.
------------------------------------------------
Height: 227.00 cm.
Mass:  87.60 kg.
Beliefs: Tsimshian mythology.
Political Party membership: Imperial British Conservative PartyÂ 
Relationship Status: 4 loving partner(s). 
Children: 1 children.
Known allergies: latex.
Blood type: AB â‚šâ‚’â‚›
You are afraid of knees.
Prexisting Health Conditions: Asthma controlled with diet & medication.
Dietary Restrictions: Halal.
Hobbies: Tether car.
Languages: North Levantine Arabic, Unish and Eskayan.
Occupation: Health Case Manager.
Security Clearance: None.
Criminal Record: No Criminal Convictions.
Arrest Record: No Arrests on File.
Warrants: No Active Warrants..
Networth: Â¥5088212.79.
Credit Score: 569.
Professional Assn: Doctor of Philosophy Candidate
Highest Education Achieved: Undergraduate.
Last School Attended: Burg Magic School.
------------------------------------------------
Your:
        Childhood home was on Aylesbury Way.
        First pet's name was Chapi.
        Childhood best-friend's name is Felix Hong.
        First vehicle:  Chrysler.
        Mother's maiden name: Hwang.
        Fursona: Dragon/Fox.
        Fighting Style: Shooting.
        Superpower is: You summon workmen (electricians.
------------------------------------------------
Your favourite/preferred:
        Colour is: Glossy grape - #AB92B3.
        Food is: Croque Monsieur.
        Ice Cream is: Phish Food.
        Poem is: Woman with Girdle - Anne Sexton.
        Flower is: Queen of the Meadow.
        Sleepwear is: t-shirt and trousers.
        Homestar Runner Character: The Blacksmith.
        Superhero is: Marvelman.
        Social Media Network is: DontStayIn.
        Season is: Autumn.
        Tree is: Quercus pontica.
        Emoji is: ðŸ˜”.
        Spectator Sport: Nymphrodell added.
        Cryptid is: Mamlambo.
        Simpsons Character is: Selma Bouvier
        Element is: Kryptonite
        Song is: Son of a Preacher Man by Dusty Springfield.
        Holiday is: Easter.
        SCP is: SCP-030-JÂ - Jim Henson is a Real Son of a Bitch.
        Album is: Backstreet's BackÂ /Â Backstreet Boys by Backstreet Boys.
        Steak doneness: Shoe Leather - 6.
        Toast Doneness: 2.
        Hot Beverage: Bovril.
        Tea/Coffee Colour: Black - A
        Soda is: Cheerwine.
        Movie is: Death by Hanging.
        Programming Language is: Prograph.
        Animal is: Rodent.
        Pokemon is: 200 Misdreavus.
        Book is: Matilda by Roald Dahl.
------------------------------------------------
