###### Your Results Are: ######
Name: Captain Faith Rajesh Mahamat-Nayak.
Citizen ID Num: 7380416C1C221F0F
First initial: F, Last initial: M.
Gender: complicated. Pronouns: she/they.
DOB: May 23, 2001 - Age: 20 years.
Birthplace: Strangereal¬†.
Primary Citizenship: TRAPPIST-1d
Associate Citizenship(s): Gabon, France, Monaco, Cambodia, Barbados, Egypt, Kepler-62f.
Star Sign: Gemini.
------------------------------------------------
Height: 118.00 cm.
Mass:  30.63 kg.
Beliefs: No strong philosophical or religious beliefs..
Political Party membership: Raving Loony Green Giant Party¬†
Relationship Status: 6 loving partner(s). 
Children: 2 children.
Known allergies: none.
Blood type: O ‚Çô·µ§‚Çó‚Çó
You are afraid of thunder and lightning.
Prexisting Health Conditions: Senior Health Issues controlled with diet & medication.
Dietary Restrictions: Vegan.
Hobbies: Figure skating.
Languages: Gujarati, Basic English.
Occupation: Appeals Referee.
Security Clearance: None.
Criminal Record: No Criminal Convictions.
Arrest Record: No Arrests on File.
Warrants: No Active Warrants..
Networth: ¬•13256.71.
Credit Score: 417.
Professional Assn: Member of the National Academy of Engineering
Highest Education Achieved: Secondary School.
Last School Attended: Greyfriars School.
------------------------------------------------
Your:
        Childhood home was on St James's Head.
        First pet's name was Ladd.
        Childhood best-friend's name is Kena Toure.
        First vehicle:  Hawk.
        Mother's maiden name: Marquez.
        Fursona: None.
        Fighting Style: Subak.
        Superpower is: Worm Regeneration.
------------------------------------------------
Your favourite/preferred:
        Colour is: Dark spring green - #177245.
        Food is: Pancit Palabok.
        Ice Cream is: Vanilla.
        Poem is: I Know Why The Caged Bird Sings - Maya Angelou.
        Flower is: Hawthorn.
        Sleepwear is: vest and trousers.
        Homestar Runner Character: The Cleric.
        Superhero is: Green Lantern.
        Social Media Network is: Jaiku.
        Season is: Spring.
        Tree is: Pisonia albida.
        Emoji is: üçÄ.
        Spectator Sport: Marbles.
        Cryptid is: Great Spider.
        Simpsons Character is: Helen Lovejoy
        Element is: Beryllium - Be
        Song is: Paranoid Android by Radiohead.
        Holiday is: U.S. State Holidays.
        SCP is: SCP-118¬†- Nuclear Protists.
        Album is: Let's Talk About Love by Celine Dion.
        Steak doneness: Medium Well - 4.
        Toast Doneness: 2.
        Hot Beverage: Earl Grey, hot.
        Tea/Coffee Colour: D
        Soda is: Liptonice.
        Movie is: E.T. the Extra-Terrestrial.
        Programming Language is: Elm.
        Animal is: Mole.
        Pokemon is: 418 Buizel.
        Book is: You Can Heal Your Life by Louise Hay.
------------------------------------------------
