###### Your Results Are: ######
Name: Gabriella Magdalena Fleming-de La Cruz, V, EI.
Citizen ID Num: 11D15B7262A72158
First initial: G, Last initial: F.
Gender: female. Pronouns: he/were.
DOB: Jan 17, 1918 - Age: 103 years.
Birthplace: Zillikian¬†.
Primary Citizenship: Lesotho
Associate Citizenship(s): ['None'].
Star Sign: Capricorn.
------------------------------------------------
Height: 124.00 cm.
Mass:  24.60 kg.
Beliefs: Churches of Christ.
Political Party membership: Undecided Cow Party
Relationship Status: Single. 
Children: 1 children.
Known allergies: aspirin.
Blood type: AB ‚Çö‚Çí‚Çõ
You are afraid of knees.
Prexisting Health Conditions: Angina controlled with diet & medication.
Dietary Restrictions: Pescatarian.
Hobbies: Dining and Radio-controlled model playing.
Languages: Portuguese, Igbo, Zaum and Ku.
Occupation: Job Analyst.
Security Clearance: None.
Criminal Record: No Criminal Convictions.
Arrest Record: No Arrests on File.
Warrants: No Active Warrants..
Networth: ¬•3678138.39.
Credit Score: 519.
Professional Assn: Professional Paralegal
Highest Education Achieved: Primary School.
Last School Attended: Baxter High.
------------------------------------------------
Your:
        Childhood home was on Drury Hall.
        First pet's name was Poh.
        Childhood best-friend's name is Hasan Kebede.
        First vehicle:  Jaguar.
        Mother's maiden name: Vaghel.
        Fursona: None.
        Fighting Style: Ky≈´d≈ç.
        Superpower is: The ability to turn into a tree at any moment.
------------------------------------------------
Your favourite/preferred:
        Colour is: Flirt - #A2006D.
        Food is: Pasta bake.
        Ice Cream is: Heath Bar Crunch Light Ice Cream.
        Poem is: The Man from Snowy River - A B Banjo Paterson.
        Flower is: Pinks.
        Sleepwear is: vest and trousers.
        Homestar Runner Character: The Paper.
        Superhero is: X-Men.
        Social Media Network is: 360voice.
        Season is: Winter.
        Tree is: Dendropanax cuneifolius[8].
        Emoji is: ü§≠.
        Spectator Sport: Basketball.
        Cryptid is: Kraken.
        Simpsons Character is: Moe Szyslak
        Element is: Helium - He
        Song is: With or Without You by U2.
        Holiday is: Islamic Holidays.
        SCP is: CODENAME: Director Bold's Proposal¬†- "Dare to Be Stupid".
        Album is: Their Greatest Hits (1971‚Äì1975) by Eagles.
        Steak doneness: Blue - 0.
        Toast Doneness: 2.
        Hot Beverage: Monster.
        Tea/Coffee Colour: D
        Soda is: La Croix Sparkling Water.
        Movie is: A Man Escaped.
        Programming Language is: Pure.
        Animal is: Bedbug.
        Pokemon is: 90 Shellder.
        Book is: Nineteen Eighty-Four by George Orwell.
------------------------------------------------
