###### Your Results Are: ######
Name: Cpl Branden Smt Chaudhari-Sani, II, CGP.
Citizen ID Num: 779C094AD007FA83
First initial: B, Last initial: C.
Gender: femme. Pronouns: any.
DOB: Sep 1, 1990 - Age: 31 years.
Birthplace: Isis¬†.
Primary Citizenship: Teegarden's Star c
Associate Citizenship(s): Greece, TRAPPIST-1e, Gliese 625 b.
Star Sign: Virgo.
------------------------------------------------
Height: 111.00 cm.
Mass:  28.34 kg.
Beliefs: No strong philosophical or religious beliefs..
Political Party membership: Fancy Dress Party¬†
Relationship Status: 7 loving partner(s). 
Children: None.
Known allergies: none.
Blood type: B ‚Çô‚Çë·µç
You are afraid of imperfection.
Prexisting Health Conditions: Oral Health Issues controlled with diet & medication.
Dietary Restrictions: Vegan.
Hobbies: Physics.
Languages: Ta Ωizzi-Adeni Arabic, Cebuano, Loxian and Loglan.
Occupation: Parts Salesperson.
Security Clearance: None.
Criminal Record: No Criminal Convictions.
Arrest Record: No Arrests on File.
Warrants: No Active Warrants..
Networth: ¬•2405898.98.
Credit Score: 835.
Professional Assn: Doctor of Philosophy Candidate
Highest Education Achieved: Post-Graduate.
Last School Attended: East High School.
------------------------------------------------
Your:
        Childhood home was on Royal Cliff.
        First pet's name was Tucker Barth.
        Childhood best-friend's name is Hector Zhuang.
        First vehicle:  Standard.
        Mother's maiden name: de Carvalho.
        Fursona: None.
        Fighting Style: Marine Corps Martial Arts Program.
        Superpower is: Can squirt your tears 10 feet.
------------------------------------------------
Your favourite/preferred:
        Colour is: Dutch white - #EFDFBB.
        Food is: Chicken and Dumplings.
        Ice Cream is: Raspberry Cheesecake.
        Poem is: Alone With Everybody - Charles Bukowski.
        Flower is: Cape Leadwort.
        Sleepwear is: boxer briefs.
        Homestar Runner Character: Fat Bluebird.
        Superhero is: Captain Marvel.
        Social Media Network is: Google Buzz.
        Season is: Autumn.
        Tree is: Prunus armeniaca.
        Emoji is: üòù.
        Spectator Sport: Rollerblading.
        Cryptid is: Ogopogo.
        Simpsons Character is: Dr. Julius Hibbert
        Element is: Wishalloy
        Song is: Dream On by Aerosmith.
        Holiday is: April Fool's Day.
        SCP is: SCP-461¬†- ZICU-TV.
        Album is: Let's Talk About Love by Celine Dion.
        Steak doneness: Medium Well - 4.
        Toast Doneness: 4.
        Hot Beverage: Tea.
        Tea/Coffee Colour: D
        Soda is: Moxie.
        Movie is: I Married a Witch.
        Programming Language is: EPL (Eltron Programming Language).
        Animal is: Dragonfly.
        Pokemon is: 136 Flareon.
        Book is: Norwegian Wood by Haruki Murakami.
------------------------------------------------
