###### Your Results Are: ######
Name: Jenee Masoumeh Zhang-Du, II, CGR.
Citizen ID Num: DFC9E4D6C05A732E
First initial: J, Last initial: Z.
Gender: complicated. Pronouns: xe/xir.
DOB: Nov 3, 1999 - Age: 22 years.
Birthplace: Altair IV¬†.
Primary Citizenship: Armenia
Associate Citizenship(s): ['None'].
Star Sign: Scorpio.
------------------------------------------------
Height: 199.00 cm.
Mass:  83.16 kg.
Beliefs: Share International.
Political Party membership: Party of the Future
Relationship Status: 1 loving partner(s). 
Children: None.
Known allergies: mould.
Blood type: A ‚Çô‚Çë·µç
You are afraid of teenagers.
Prexisting Health Conditions: Arthritis controlled with diet & medication.
Dietary Restrictions: Vegetarian.
Hobbies: Skateboarding and Outdoors.
Languages: South Azerbaijani, Logopandecteision.
Occupation: Database Administrator.
Security Clearance: None.
Criminal Record: No Criminal Convictions.
Arrest Record: No Arrests on File.
Warrants: No Active Warrants..
Networth: ¬•1173285.33.
Credit Score: 565.
Professional Assn: Certified Senior Broadcast Television Engineer
Highest Education Achieved: Primary School.
Last School Attended: University of Bantshire.
------------------------------------------------
Your:
        Childhood home was on Cunningham Oak.
        First pet's name was DAKO Royal Star Ranger.
        Childhood best-friend's name is Yanling Ibarra.
        First vehicle:  Adams-Farwell.
        Mother's maiden name: Scott.
        Fursona: None.
        Fighting Style: Bal Vidya.
        Superpower is: Your bodily fluids are all highly acidic.
------------------------------------------------
Your favourite/preferred:
        Colour is: Magenta (process) - #FF0090.
        Food is: Cheese toastie.
        Ice Cream is: That's Life Apple Pie.
        Poem is: Autumn - Roy Campbell.
        Flower is: Balloon Flower.
        Sleepwear is: bra.
        Homestar Runner Character: Gavin.
        Superhero is: Aquaman.
        Social Media Network is: LinguaLeo.
        Season is: Summer.
        Tree is: Capparidaceae.
        Emoji is: üå∏.
        Spectator Sport: Beach Soccer.
        Cryptid is: Loch Ness Monster.
        Simpsons Character is: Duffman
        Element is: Katchin
        Song is: Bohemian Rhapsody by Queen.
        Holiday is: National Holidays Worldwide.
        SCP is: SCP-694¬†- The Definition of Insanity.
        Album is: No Jacket Required by Phil Collins.
        Steak doneness: Medium - 3.
        Toast Doneness: White - 0.
        Hot Beverage: Tea.
        Tea/Coffee Colour: Black - A
        Soda is: Fanta Citrus.
        Movie is: Samurai Spy.
        Programming Language is: Ch.
        Animal is: Buzzard.
        Pokemon is: 21 Spearow.
        Book is: Lust for Life by Irving Stone.
------------------------------------------------
