###### Your Results Are: ######
Name: General Petr Jinny Souza-Wright.
Citizen ID Num: D6E7367A4B9EB12F
First initial: P, Last initial: S.
Gender: complicated. Pronouns: they/them.
DOB: Nov 7, 1962 - Age: 59 years.
Birthplace: KaravaÂ .
Primary Citizenship: Tau Ceti f
Associate Citizenship(s): Indonesia, Teegarden's Star c, Saudi Arabia, Kepler-1653b, Hungary, Austria, Comoros.
Star Sign: Scorpio.
------------------------------------------------
Height: 110.00 cm.
Mass:  31.46 kg.
Beliefs: Zaidiyyah.
Political Party membership: APPDÂ (Anarchist Pogo Party of Germany)
Relationship Status: Single. 
Children: 2 children.
Known allergies: insect bites.
Blood type: O â‚šâ‚’â‚›
You are afraid of flying.
Prexisting Health Conditions: Thyroid Trouble controlled with diet & medication.
Dietary Restrictions: Fruititarian.
Hobbies: Leather crafting.
Languages: Polish, Interlac and Klingon.
Occupation: Pressing Machine Operator.
Security Clearance: Public Trust Position - Moderate Risk.
Criminal Record: No Criminal Convictions.
Arrest Record: No Arrests on File.
Warrants: No Active Warrants..
Networth: Â¥665008.11.
Credit Score: 619.
Professional Assn: Certified HIPAA Security Specialist
Highest Education Achieved: Masters.
Last School Attended: Malory Towers.
------------------------------------------------
Your:
        Childhood home was on Lords Brook.
        First pet's name was Inga.
        Childhood best-friend's name is Giuseppe Boyle.
        First vehicle:  Aptera.
        Mother's maiden name: Mou.
        Fursona: None.
        Fighting Style: Yiquan.
        Superpower is: Can change the tv channel with you mind.
------------------------------------------------
Your favourite/preferred:
        Colour is: Granny Smith apple - #A8E4A0.
        Food is: Dark Chocolate.
        Ice Cream is: Sambucca Coffee Flake.
        Poem is: Sailor Town - Cicely Fox Smith.
        Flower is: Clover.
        Sleepwear is: panties.
        Homestar Runner Character: Homestar Jr..
        Superhero is: Batgirl.
        Social Media Network is: Twitter.
        Season is: Spring.
        Tree is: Drypetes gerrardii.
        Emoji is: ðŸ‘Š.
        Spectator Sport: Snowboarding.
        Cryptid is: Mongolian death worm.
        Simpsons Character is: Mayor Joe Quimby
        Element is: Promethium - Pm
        Song is: Please.
        Holiday is: Ramadan.
        SCP is: SCP-839Â - Candied Worms.
        Album is: The Woman in Me by Shania Twain.
        Steak doneness: Medium Rare - 2.
        Toast Doneness: 2.
        Hot Beverage: Coffee.
        Tea/Coffee Colour: C
        Soda is: MDX.
        Movie is: Sawdust and Tinsel.
        Programming Language is: Jess (programming language).
        Animal is: Flamingo.
        Pokemon is: 422 Shellos.
        Book is: Virgin Soil Upturned by Mikhail Sholokhov.
------------------------------------------------
