###### Your Results Are: ######
Name: Admiral Ngoc Luba Araujo-Ma, III.
Citizen ID Num: E2A1248DB560BA1B
First initial: N, Last initial: A.
Gender: male. Pronouns: any.
DOB: Feb 10, 1908 - Age: 113 years.
Birthplace: Oa the Living PlanetÂ .
Primary Citizenship: Kepler-1638b
Associate Citizenship(s): Norway, Benin, Kiribati, Croatia, Hungary, Syria, Latvia.
Star Sign: Aquarius.
------------------------------------------------
Height: 132.00 cm.
Mass:  27.88 kg.
Beliefs: No strong philosophical or religious beliefs..
Political Party membership: Parti Ã©lÃ©phant blanc de MontrÃ©al
Relationship Status: Single. 
Children: None.
Known allergies: none.
Blood type: B â‚™áµ¤â‚—â‚—
You are afraid of needles or pointed objects.
Prexisting Health Conditions: Depression controlled with diet & medication.
Dietary Restrictions: Gluten-free.
Hobbies: Stuffed toy collecting.
Languages: Northern Kurdish, Sona.
Occupation: Tool & Machine Designer.
Security Clearance: None.
Criminal Record: No Criminal Convictions.
Arrest Record: No Arrests on File.
Warrants: No Active Warrants..
Networth: Â¥4119077.51.
Credit Score: 696.
Professional Assn: Certified Virtualization Professional
Highest Education Achieved: Masters.
Last School Attended: Baxter High.
------------------------------------------------
Your:
        Childhood home was on Rodridge Park.
        First pet's name was Charro.
        Childhood best-friend's name is Daniel Haji.
        First vehicle:  GMC.
        Mother's maiden name: Majhi.
        Fursona: None.
        Fighting Style: Southern Dragon Kung Fu.
        Superpower is: Remember every number you've ever heard.
------------------------------------------------
Your favourite/preferred:
        Colour is: Madder Lake - #CC3336.
        Food is: Mashed Potatoes.
        Ice Cream is: Raspberry Renewal Smoothie.
        Poem is: A Woman to her Lover - Christina Walshe.
        Flower is: Peace Lily.
        Sleepwear is: t-shirt.
        Homestar Runner Character: Homestar Runner.
        Superhero is: Asterix.
        Social Media Network is: Red Light Center.
        Season is: Winter.
        Tree is: Cupania americana.
        Emoji is: ðŸ˜š.
        Spectator Sport: Tennis.
        Cryptid is: Manipogo.
        Simpsons Character is: Mrs. Vanderbilt
        Element is: Aluminium - Al
        Song is: Summer Babe [Winter Version] by Pavement.
        Holiday is: Mother's Day.
        SCP is: SCP-4263-JÂ - Googly Eyes.
        Album is: Legend: The Best of Bob Marley & The Wailers by Bob MarleyÂ & The Wailers.
        Steak doneness: Medium - 3.
        Toast Doneness: Burnt - 6.
        Hot Beverage: Earl Grey, hot.
        Tea/Coffee Colour: D
        Soda is: Mecca Cola.
        Movie is: Seven Samurai.
        Programming Language is: FFP.
        Animal is: Anaconda.
        Pokemon is: 689 Barbaracle.
        Book is: No Longer Human by Osamu Dazai.
------------------------------------------------
