###### Your Results Are: ######
Name: Pvt. Johna Samara Blanco-Salem, II.
Citizen ID Num: 91877A52CF5ECC00
First initial: J, Last initial: B.
Gender: none. Pronouns: ey/em.
DOB: May 7, 1904 - Age: 117 years.
Birthplace: Terra.
Primary Citizenship: Uganda
Associate Citizenship(s): Holy See, Yemen.
Star Sign: Taurus.
------------------------------------------------
Height: 137.00 cm.
Mass:  60.06 kg.
Beliefs: Sahajdhari.
Political Party membership: Bill and Ben Party 
Relationship Status: Single. 
Children: None.
Known allergies: none.
Blood type: A ₚₒₛ
You are afraid of beautiful women.
Prexisting Health Conditions: Alzheimer's controlled with diet & medication.
Dietary Restrictions: Vegan.
Hobbies: Video game developing.
Languages: Nigerian Fulfulde, Jin Chinese, Babm and Trigedasleng.
Occupation: Offset Press Operators.
Security Clearance: None.
Criminal Record: No Criminal Convictions.
Arrest Record: No Arrests on File.
Warrants: No Active Warrants..
Networth: ¥1787650.44.
Credit Score: 742.
Professional Assn: Oracle Certified Professional
Highest Education Achieved: Secondary School.
Last School Attended: Ackley Bridge College.
------------------------------------------------
Your:
        Childhood home was on Belle Vue Chase.
        First pet's name was Wicket.
        Childhood best-friend's name is Van Salem.
        First vehicle:  Chandler.
        Mother's maiden name: Harris.
        Fursona: Chinchilla.
        Fighting Style: Tinju.
        Superpower is: You meet every deadline.
------------------------------------------------
Your favourite/preferred:
        Colour is: French raspberry - #C72C48.
        Food is: Pizza.
        Ice Cream is: Peach.
        Poem is: Alone With Everybody - Charles Bukowski.
        Flower is: Start with C.
        Sleepwear is: vest and boxer briefs.
        Homestar Runner Character: Grandmaw Auntpaw.
        Superhero is: Batgirl.
        Social Media Network is: TikTok.
        Season is: Autumn.
        Tree is: Cyrilla racemiflora.
        Emoji is: ❤️.
        Spectator Sport: Snowboarding.
        Cryptid is: Terrestrial.
        Simpsons Character is: Lisa Simpson
        Element is: Neon - Ne
        Song is: All Along the Watchtower by Jimi Hendrix.
        Holiday is: Bloomsday.
        SCP is: SCP-939 - With Many Voices.
        Album is: Tracy Chapman by Tracy Chapman.
        Steak doneness: Blue - 0.
        Toast Doneness: White - 0.
        Hot Beverage: Earl Grey, hot.
        Tea/Coffee Colour: Black - A
        Soda is: Diet Inca Kola.
        Movie is: The Inland Sea.
        Programming Language is: JASS.
        Animal is: Puffin.
        Pokemon is: 339 Barboach.
        Book is: Watership Down by Richard Adams.
------------------------------------------------
