###### Your Results Are: ######
Name: Sarai Kathlene Mckay-Magar.
Citizen ID Num: 4FCB1F5B035864B3
First initial: S, Last initial: M.
Gender: male. Pronouns: she/her.
DOB: Feb 24, 1958 - Age: 63 years.
Birthplace: SeraÂ .
Primary Citizenship: France
Associate Citizenship(s): Taured, Japan, Libya.
Star Sign: Pisces.
------------------------------------------------
Height: 61.00 cm.
Mass:  8.56 kg.
Beliefs: Reformed churches.
Political Party membership: Canadian Extreme Wrestling Party
Relationship Status: 3 loving partner(s). 
Children: 5 children.
Known allergies: none.
Blood type: AB â‚šâ‚’â‚›
You are afraid of the figure 8.
Prexisting Health Conditions: Dictionary controlled with diet & medication.
Dietary Restrictions: Vegan.
Hobbies: Photography.
Languages: Wu Chinese, Polish, Interlac.
Occupation: Elementary School Administrator.
Security Clearance: None.
Criminal Record: No Criminal Convictions.
Arrest Record: No Arrests on File.
Warrants: No Active Warrants..
Networth: Â¥3557164.71.
Credit Score: 315.
Professional Assn: Associate Fellow of the Aerospace Medical Association
Highest Education Achieved: Secondary School.
Last School Attended: John Adams Middle School.
------------------------------------------------
Your:
        Childhood home was on Telford Hollies.
        First pet's name was Mina McCarty.
        Childhood best-friend's name is Arthur Rogers.
        First vehicle:  Rauch and Lang.
        Mother's maiden name: Sinh.
        Fursona: None.
        Fighting Style: Korea.
        Superpower is: Everything you put in your mouth tastes awful.
------------------------------------------------
Your favourite/preferred:
        Colour is: Ochre - #CC7722.
        Food is: Turon.
        Ice Cream is: Peach.
        Poem is: may i feel said he - E.e. cummings.
        Flower is: Iceland Poppy.
        Sleepwear is: t-shirt and panties.
        Homestar Runner Character: The Grape Fairie.
        Superhero is: Fantastic Four.
        Social Media Network is: Rentboy.com.
        Season is: Summer.
        Tree is: Calodendrum eickii.
        Emoji is: ðŸ‘‡.
        Spectator Sport: Darts.
        Cryptid is: Almas.
        Simpsons Character is: Julio
        Element is: Doudecimates
        Song is: Loser by Beck.
        Holiday is: U.S. State Holidays.
        SCP is: SCP-164-JÂ - Ear Magic.
        Album is: Faith by George Michael.
        Steak doneness: Shoe Leather - 6.
        Toast Doneness: 5.
        Hot Beverage: Monster.
        Tea/Coffee Colour: Black - A
        Soda is: Corona.
        Movie is: Gate of Flesh.
        Programming Language is: F# (F sharp).
        Animal is: Walrus.
        Pokemon is: 633 Deino.
        Book is: Follow Your Heart by Susanna Tamaro.
------------------------------------------------
