###### Your Results Are: ######
Name: Admiral Sofia Justin Morales-Xavier.
Citizen ID Num: C06E29EB4AFECA83
First initial: S, Last initial: M.
Gender: nonbinary. Pronouns: he/him.
DOB: Sep 17, 1999 - Age: 22 years.
Birthplace: Iris.
Primary Citizenship: The CIC
Associate Citizenship(s): Belarus, Yemen, Poland, France, Jordan.
Star Sign: Virgo.
------------------------------------------------
Height: 115.00 cm.
Mass:  38.35 kg.
Beliefs: No strong philosophical or religious beliefs..
Political Party membership: APPDÂ (Anarchist Pogo Party of Germany)
Relationship Status: Single. 
Children: 3 children.
Known allergies: none.
Blood type: AB â‚šâ‚’â‚›
You are afraid of thunder and lightning.
Prexisting Health Conditions: Cancer controlled with diet & medication.
Dietary Restrictions: Fruititarian.
Hobbies: Home improvement.
Languages: Portuguese, VolapÃ¼k.
Occupation: Medical Administrative Assistant.
Security Clearance: Vulnerable Group Access.
Criminal Record: No Criminal Convictions.
Arrest Record: No Arrests on File.
Warrants: No Active Warrants..
Networth: Â¥677222.61.
Credit Score: 647.
Professional Assn: Certified Hospice and Palliative Licensed Nurse
Highest Education Achieved: Secondary School.
Last School Attended: Constance Billard.
------------------------------------------------
Your:
        Childhood home was on Melrose Quadrant.
        First pet's name was DiMaggio.
        Childhood best-friend's name is Mohammed Nam.
        First vehicle:  GMC.
        Mother's maiden name: Vo.
        Fursona: Dragon/Kangaroo.
        Fighting Style: Jujutsu.
        Superpower is: When you cover your eyes.
------------------------------------------------
Your favourite/preferred:
        Colour is: Electric indigo - #6F00FF.
        Food is: Perogies.
        Ice Cream is: Vanilla Malted Milk.
        Poem is: Life - Charlotte Bronte.
        Flower is: Cardinal Flower.
        Sleepwear is: boxers.
        Homestar Runner Character: Humidibot.
        Superhero is: Asterix.
        Social Media Network is: Dead Runners Society.
        Season is: Winter.
        Tree is: Mango (Mangifera indica).
        Emoji is: ðŸ˜ª.
        Spectator Sport: Handball.
        Cryptid is: Mothman.
        Simpsons Character is: Sideshow Bob
        Element is: Bromine - Br
        Song is: Sloop John B by The Beach Boys.
        Holiday is: Boxing Day.
        SCP is: SCP-071Â - Degenerative Metamorphic Entity.
        Album is: All the Way... A Decade of Song by Celine Dion.
        Steak doneness: Medium Well - 4.
        Toast Doneness: White - 0.
        Hot Beverage: Tea.
        Tea/Coffee Colour: White - F
        Soda is: Ramune.
        Movie is: Desert Hearts.
        Programming Language is: ObjectLOGO.
        Animal is: Chicken breeds.
        Pokemon is: 549 Lilligant.
        Book is: Uncle Styopa by Sergey Mikhalkov.
------------------------------------------------
