###### Your Results Are: ######
Name: Pvt. Ali Vanessa Fang-Franco.
Citizen ID Num: 650192D1E947D67B
First initial: A, Last initial: F.
Gender: none. Pronouns: ey/em.
DOB: Oct 7, 1919 - Age: 102 years.
Birthplace: Rubanis¬†.
Primary Citizenship: TRAPPIST-1d
Associate Citizenship(s): Gabon, Gliese 1061 c, Singapore, Honduras, Kyrgyzstan, Vietnam, Turkmenistan.
Star Sign: Libra.
------------------------------------------------
Height: 116.00 cm.
Mass:  32.29 kg.
Beliefs: Philippine Dayawism.
Political Party membership: Beer Lovers Party¬†
Relationship Status: Single. 
Children: 2 children.
Known allergies: none.
Blood type: A ‚Çô‚Çë·µç
You are afraid of stairs or steep slopes.
Prexisting Health Conditions: Pregnancy Complications controlled with diet & medication.
Dietary Restrictions: Vegan.
Hobbies: Mechanics.
Languages: Cebuano, Wu Chinese, Dritok.
Occupation: Instructional Coordinators.
Security Clearance: TS: Yankee White.
Criminal Record: No Criminal Convictions.
Arrest Record: No Arrests on File.
Warrants: No Active Warrants..
Networth: ¬•2205204.08.
Credit Score: 793.
Professional Assn: Mobile Intensive Care Paramedic (Alaska)
Highest Education Achieved: Doctoral.
Last School Attended: St Rule's University.
------------------------------------------------
Your:
        Childhood home was on Falkland Chase.
        First pet's name was Inky Jinx.
        Childhood best-friend's name is Surendra Shen.
        First vehicle:  Navistar.
        Mother's maiden name: Choe.
        Fursona: Fox/Tiger.
        Fighting Style: Suntukan.
        Superpower is: Memorize song lyrics perfectly on the first listen.
------------------------------------------------
Your favourite/preferred:
        Colour is: Maroon (Crayola) - #C32148.
        Food is: Indian Fry Bread.
        Ice Cream is: Kaffaretto.
        Poem is: Brimming Water by Tu Fu (712-770) - Du Fu.
        Flower is: Firethorn.
        Sleepwear is: bra.
        Homestar Runner Character: Lord Quackingstick.
        Superhero is: Thor.
        Social Media Network is: MouthShut.com.
        Season is: Summer.
        Tree is: Combretaceae.
        Emoji is: üëÄ.
        Spectator Sport: Australian Rules football.
        Cryptid is: Chupacabra.
        Simpsons Character is: Chief Clancy Wiggum
        Element is: Chronoton
        Song is: No Woman No Cry by Bob Marley & The Wailers.
        Holiday is: St. Patrick's Day.
        SCP is: SCP-963¬†- Immortality.
        Album is: Grease: The Original Soundtrack from the Motion Picture by the Motion Picture Cast.
        Steak doneness: Well Done - 5.
        Toast Doneness: 5.
        Hot Beverage: Coffee.
        Tea/Coffee Colour: D
        Soda is: Tangerine.
        Movie is: Stray Dog.
        Programming Language is: FOCUS.
        Animal is: Swan.
        Pokemon is: 321 Wailord.
        Book is: The Happy Hooker: My Own Story by Xaviera Hollander.
------------------------------------------------
