###### Your Results Are: ######
Name: Prof. Conception Jenee Song-Balde.
Citizen ID Num: 9E6FB6DA95EE6DF7
First initial: C, Last initial: S.
Gender: masc. Pronouns: xe/xir.
DOB: Apr 14, 1992 - Age: 29 years.
Birthplace: Aldabra .
Primary Citizenship: Andorra
Associate Citizenship(s): ['None'].
Star Sign: Aries.
------------------------------------------------
Height: 157.00 cm.
Mass:  69.02 kg.
Beliefs: No strong philosophical or religious beliefs..
Political Party membership: Beer Lovers Party
Relationship Status: 3 loving partner(s). 
Children: 4 children.
Known allergies: none.
Blood type: A ₚₒₛ
You are afraid of disease.
Prexisting Health Conditions: Infectious Disease controlled with diet & medication.
Dietary Restrictions: Lemba.
Hobbies: Video gaming and Mazes (indoor/outdoor).
Languages: Eastern Punjabi, Voynich.
Occupation: Mechanical Engineering Technician.
Security Clearance: None.
Criminal Record: Criminal Convictions on File.
Arrest Record: Arrest Record on File.
Warrants: No Active Warrants..
Networth: ¥4690851.11.
Credit Score: 369.
Professional Assn: Master of Fine Arts
Highest Education Achieved: Undergraduate.
Last School Attended: Riverdale High.
------------------------------------------------
Your:
        Childhood home was on Leneda Drive.
        First pet's name was Eutolmia.
        Childhood best-friend's name is Christina Khatun.
        First vehicle:  Fisker.
        Mother's maiden name: Caudhari.
        Fursona: None.
        Fighting Style: Lau Gar.
        Superpower is: Can turn goats into holograms of Abe Vigoda.
------------------------------------------------
Your favourite/preferred:
        Colour is: Granny Smith apple - #A8E4A0.
        Food is: Lumpia.
        Ice Cream is: Peanuts! Popcorn!.
        Poem is: 2 a.m. - Ernesto Trejo.
        Flower is: Flowering Dogwood.
        Sleepwear is: t-shirt and boxers.
        Homestar Runner Character: The Robot.
        Superhero is: The Avengers.
        Social Media Network is: Bolt.
        Season is: Autumn.
        Tree is: Vitis vinifera.
        Emoji is: ✔️.
        Spectator Sport: Baseball.
        Cryptid is: Mngwa.
        Simpsons Character is: Bart Simpson
        Element is: Roentgenium - Rg
        Song is: Train in Vain by The Clash.
        Holiday is: Valentine's Day.
        SCP is: SCP-111 - Dragon-Snails™.
        Album is: The Miseducation of Lauryn Hill by Lauryn Hill.
        Steak doneness: Medium Well - 4.
        Toast Doneness: 4.
        Hot Beverage: Tea.
        Tea/Coffee Colour: B
        Soda is: Coca-Cola Cherry.
        Movie is: A Story of Floating Weeds / Floating Weeds.
        Programming Language is: Newspeak.
        Animal is: Llama.
        Pokemon is: 231 Phanpy.
        Book is: The Girl With The Dragon Tattoo by Stieg Larsson.
------------------------------------------------
