###### Your Results Are: ######
Name: Tong Cristopher Hou-George.
Citizen ID Num: A47A9FF22060BFB3
First initial: T, Last initial: H.
Gender: female. Pronouns: he/were.
DOB: Sep 16, 1992 - Age: 29 years.
Birthplace: Thor¬†.
Primary Citizenship: Kepler-62e
Associate Citizenship(s): Kepler-705b, New Zealand, Rwanda, Jordan.
Star Sign: Virgo.
------------------------------------------------
Height: 255.00 cm.
Mass:  123.55 kg.
Beliefs: No strong philosophical or religious beliefs..
Political Party membership: Party for Labour
Relationship Status: 5 loving partner(s). 
Children: None.
Known allergies: insect bites.
Blood type: O ‚Çô‚Çë·µç
You are afraid of darkness.
Prexisting Health Conditions: Chronic Pain controlled with diet & medication.
Dietary Restrictions: Ketogenic.
Hobbies: Slot car racing.
Languages: Maithili, L√°adan¬†(ldn) and Solresol.
Occupation: Bulldozer / Grader Operator.
Security Clearance: None.
Criminal Record: Criminal Convictions on File.
Arrest Record: Arrest Record on File.
Warrants: No Active Warrants..
Networth: ¬•1544575.75.
Credit Score: 790.
Professional Assn: Certified Green IT Professional
Highest Education Achieved: Post-Graduate.
Last School Attended: John Adams High School.
------------------------------------------------
Your:
        Childhood home was on Northern Hawthorns.
        First pet's name was OMalley.
        Childhood best-friend's name is Wendy Hamza.
        First vehicle:  London.
        Mother's maiden name: Hunter.
        Fursona: Mexican.
        Fighting Style: Wrestling.
        Superpower is: Offspring Detection.
------------------------------------------------
Your favourite/preferred:
        Colour is: Hot pink - #FF69B4.
        Food is: Tocino.
        Ice Cream is: Hazelnut.
        Poem is: Have A Nice day - Spike Milligan.
        Flower is: Ipomoea Lobata.
        Sleepwear is: bra.
        Homestar Runner Character: Stooly.
        Superhero is: Aquaman.
        Social Media Network is: Qaiku.
        Season is: Summer.
        Tree is: Juglans nigra.
        Emoji is: üôã.
        Spectator Sport: Australian Rules football.
        Cryptid is: St. Johns River Monster.
        Simpsons Character is: Herman Hermann
        Element is: Octiron
        Song is: Graceland by Paul Simon.
        Holiday is: Bloomsday.
        SCP is: SCP-609¬†- Dr. Wondertainment's Ontological 6-Balls¬Æ.
        Album is: Music Box by Mariah Carey.
        Steak doneness: Rare - 1.
        Toast Doneness: done on one side.
        Hot Beverage: Earl Grey, hot.
        Tea/Coffee Colour: White - F
        Soda is: Ambasa.
        Movie is: The Other Side of Hope.
        Programming Language is: CoffeeScript.
        Animal is: Minnow.
        Pokemon is: 369 Relicanth.
        Book is: The Book Thief by Markus Zusak.
------------------------------------------------
