###### Your Results Are: ######
Name: Prof. Leoma Abdul Robinson-Ran, CSC.
Citizen ID Num: 25803AE8AFCDEDDC
First initial: L, Last initial: R.
Gender: complicated. Pronouns: ey/em.
DOB: Feb 7, 2000 - Age: 21 years.
Birthplace: NibiruÂ .
Primary Citizenship: Taured
Associate Citizenship(s): Gliese 3293 d, Nicaragua, Comoros, Kepler-296f.
Star Sign: Aquarius.
------------------------------------------------
Height: 259.00 cm.
Mass:  221.37 kg.
Beliefs: International Swaminarayan Satsang Mandal.
Political Party membership: Guns and Dope Party
Relationship Status: Single. 
Children: 1 children.
Known allergies: aspirin.
Blood type: AB â‚™áµ¤â‚—â‚—
You are afraid of riding in a car.
Prexisting Health Conditions: Farsightedness controlled with diet & medication.
Dietary Restrictions: Lemba.
Hobbies: Renaissance fair and Bowling.
Languages: Sudanese Arabic, Interlingua.
Occupation: Broadcast Technician.
Security Clearance: None.
Criminal Record: No Criminal Convictions.
Arrest Record: No Arrests on File.
Warrants: No Active Warrants..
Networth: Â¥3691120.19.
Credit Score: 640.
Professional Assn: Associate Professional in Talent Development
Highest Education Achieved: Secondary School.
Last School Attended: Weyland Utani Technical Institute.
------------------------------------------------
Your:
        Childhood home was on Dudley Road East.
        First pet's name was Trotsky.
        Childhood best-friend's name is Maura Uddin.
        First vehicle:  Radical.
        Mother's maiden name: Salah.
        Fursona: None.
        Fighting Style: Emeiquan.
        Superpower is: Ability to read peoples minds but only in languages other than your native tongue..
------------------------------------------------
Your favourite/preferred:
        Colour is: English green - #1B4D3E.
        Food is: Chocolate Chip Cookies.
        Ice Cream is: Vanilla with Heath Toffee Crunch Low Fat Frozen Yogurt.
        Poem is: Jazz Fantasia - Carl Sandburg.
        Flower is: Cerastium Tomentosum.
        Sleepwear is: bra.
        Homestar Runner Character: Nibbles.
        Superhero is: Iron Man.
        Social Media Network is: Wooxie.
        Season is: Autumn.
        Tree is: Western Redcedar (Thuja plicata).
        Emoji is: ðŸ˜ª.
        Spectator Sport: Triathlon.
        Cryptid is: Selma.
        Simpsons Character is: Krusty The Clown
        Element is: Inoson
        Song is: River Deep - Mountain High by Tina Turner.
        Holiday is: Valentine's Day.
        SCP is: SCP-799Â - Carnivorous Blanket.
        Album is: The Wall by Pink Floyd.
        Steak doneness: Medium Rare - 2.
        Toast Doneness: 4.
        Hot Beverage: Tea.
        Tea/Coffee Colour: C
        Soda is: Barrelhead Root Beer.
        Movie is: David Lynch: The Art Life.
        Programming Language is: M#.
        Animal is: Angelfish.
        Pokemon is: 137 Porygon.
        Book is: The Giver by Lois Lowry.
------------------------------------------------
