###### Your Results Are: ######
Name: Dr. Gil Lucy Bekele-Yƒ±ldƒ±rƒ±m, Sr..
Citizen ID Num: 4D4B7CB25B6C07D3
First initial: G, Last initial: B.
Gender: female. Pronouns: he/were.
DOB: Jan 2, 1953 - Age: 68 years.
Birthplace: HD 28185b.
Primary Citizenship: The CIC
Associate Citizenship(s): Nauru, Kepler-296e, Sierra Leone, Grenada.
Star Sign: Capricorn.
------------------------------------------------
Height: 203.00 cm.
Mass:  78.30 kg.
Beliefs: The Family International.
Political Party membership: The Party Party
Relationship Status: Single. 
Children: 4 children.
Known allergies: shellfish.
Blood type: AB ‚Çô·µ§‚Çó‚Çó
You are afraid of numbers.
Prexisting Health Conditions: Depression controlled with diet & medication.
Dietary Restrictions: Pescatarian.
Hobbies: Coloring.
Languages: Min Dong Chinese, Uyghur, Unnamed language.
Occupation: Recreational Therapist.
Security Clearance: None.
Criminal Record: No Criminal Convictions.
Arrest Record: No Arrests on File.
Warrants: No Active Warrants..
Networth: ¬•5475675.82.
Credit Score: 718.
Professional Assn: Aviation Medical Examiner
Highest Education Achieved: Doctoral.
Last School Attended: St Luke's University Bristol.
------------------------------------------------
Your:
        Childhood home was on Luxor Street.
        First pet's name was Makola.
        Childhood best-friend's name is Madina Fatima.
        First vehicle:  Cole.
        Mother's maiden name: Thompson.
        Fursona: Lemur.
        Fighting Style: Oco Ocho.
        Superpower is: Can make the sound of a tree falling in the forest with no one to hear it.
------------------------------------------------
Your favourite/preferred:
        Colour is: Cerise - #DE3163.
        Food is: Tocino.
        Ice Cream is: Vanilla Chocolate Chunk.
        Poem is: Prayers To Lord Murugan - A.K. Ramanujan.
        Flower is: Catmint.
        Sleepwear is: bra and boxer briefs.
        Homestar Runner Character: Atari Dragon.
        Superhero is: The Shadow.
        Social Media Network is: Blind.
        Season is: Winter.
        Tree is: Maytenus.
        Emoji is: üëè.
        Spectator Sport: MMA.
        Cryptid is: Chuchunya.
        Simpsons Character is: Sideshow Bob
        Element is: Rearden Metal
        Song is: Mack the Knife by Bobby Darin.
        Holiday is: May Day.
        SCP is: SCP-432¬†- Cabinet Maze.
        Album is: Oops!... I Did It Again by Britney Spears.
        Steak doneness: Rare - 1.
        Toast Doneness: 3.
        Hot Beverage: Monster.
        Tea/Coffee Colour: C
        Soda is: Barr.
        Movie is: Vengeance Is Mine.
        Programming Language is: PL/0.
        Animal is: Crane.
        Pokemon is: 253 Grovyle.
        Book is: The Hunger Games by Suzanne Collins.
------------------------------------------------
