###### Your Results Are: ######
Name: Pavel Nour de Souza-Blanco, Esq..
Citizen ID Num: 3F0AF7BEED322F87
First initial: P, Last initial: d.
Gender: nonbinary. Pronouns: any.
DOB: Jan 27, 1925 - Age: 96 years.
Birthplace: Ringworld¬†.
Primary Citizenship: Mali
Associate Citizenship(s): Brunei, Cuba, Colombia, Belarus, Sudan, Benin, United States of America.
Star Sign: Aquarius.
------------------------------------------------
Height: 151.00 cm.
Mass:  59.28 kg.
Beliefs: No strong philosophical or religious beliefs..
Political Party membership: The Civilian Party¬†
Relationship Status: 3 loving partner(s). 
Children: None.
Known allergies: animal dander.
Blood type: O ‚Çô‚Çë·µç
You are afraid of needles or pointed objects.
Prexisting Health Conditions: Heart Problems controlled with diet & medication.
Dietary Restrictions: Pescatarian.
Hobbies: Dining.
Languages: Yue Chinese, Quenya and Solresol.
Occupation: Stress Analyst Engineer.
Security Clearance: None.
Criminal Record: Criminal Convictions on File.
Arrest Record: Arrest Record on File.
Warrants: No Active Warrants..
Networth: ¬•3360888.96.
Credit Score: 627.
Professional Assn: Certified Scrum Product Owner
Highest Education Achieved: Doctoral.
Last School Attended: Neptune High.
------------------------------------------------
Your:
        Childhood home was on Old School Piece.
        First pet's name was Jimmy.
        Childhood best-friend's name is Jocelyn Kato.
        First vehicle:  Apperson.
        Mother's maiden name: Paul.
        Fursona: Frog.
        Fighting Style: Combatives.
        Superpower is: Worm Regeneration.
------------------------------------------------
Your favourite/preferred:
        Colour is: Irresistible - #B3446C.
        Food is: Lasagne.
        Ice Cream is: Coconut Cream Pie.
        Poem is: An Old Man's Winter Night - Robert Frost.
        Flower is: Moonflower Vine.
        Sleepwear is: vest and boxer briefs.
        Homestar Runner Character: Mr. Poofers.
        Superhero is: Hawkeye.
        Social Media Network is: Meetro.
        Season is: Winter.
        Tree is: Colubrina elliptica.
        Emoji is: üò†.
        Spectator Sport: Badminton.
        Cryptid is: Great Spider.
        Simpsons Character is: Reverend Timothy Lovejoy
        Element is: Ruthenium - Ru
        Song is: Tighten Up by Archie Bell & The Drells.
        Holiday is: Easter.
        SCP is: SCP-341¬†- A Collection of Extra-Solar Orreries.
        Album is: Breakfast in America by Supertramp.
        Steak doneness: Shoe Leather - 6.
        Toast Doneness: White - 0.
        Hot Beverage: Coffee.
        Tea/Coffee Colour: B
        Soda is: Sprite.
        Movie is: Jaws.
        Programming Language is: Pico.
        Animal is: Whale.
        Pokemon is: 201 Unown.
        Book is: The Dukan Diet by Pierre Dukan.
------------------------------------------------
