###### Your Results Are: ######
Name: Andera Elanor Lara-≈ûahin, Jr..
Citizen ID Num: 68041DD24ED1B673
First initial: A, Last initial: L.
Gender: complicated. Pronouns: she/wif.
DOB: Jan 20, 1909 - Age: 112 years.
Birthplace: Mobius.
Primary Citizenship: Nauru
Associate Citizenship(s): Norway, K2-296b.
Star Sign: Capricorn.
------------------------------------------------
Height: 145.00 cm.
Mass:  63.08 kg.
Beliefs: Gardnerian Wicca.
Political Party membership: Surprise Party
Relationship Status: 4 loving partner(s). 
Children: 4 children.
Known allergies: aspirin.
Blood type: B ‚Çô‚Çë·µç
You are afraid  of touch.
Prexisting Health Conditions: Narcolepsy controlled with diet & medication.
Dietary Restrictions: Words of Wisom.
Hobbies: Hiking.
Languages: Sanaani Spoken Arabic, Khmer, Eskayan.
Occupation: Anti-Terrorism Intelligence Agent.
Security Clearance: None.
Criminal Record: No Criminal Convictions.
Arrest Record: No Arrests on File.
Warrants: No Active Warrants..
Networth: ¬•4414929.11.
Credit Score: 691.
Professional Assn: Microsoft Certified Professional Developer
Highest Education Achieved: Masters.
Last School Attended: Lowood Institution.
------------------------------------------------
Your:
        Childhood home was on St George's Oak.
        First pet's name was Graciegirl.
        Childhood best-friend's name is Xing Lai.
        First vehicle:  BAC.
        Mother's maiden name: Brito.
        Fursona: Ignuana.
        Fighting Style: Fu Jow Pai.
        Superpower is: Communing with squirrels.
------------------------------------------------
Your favourite/preferred:
        Colour is: Jungle green - #29AB87.
        Food is: New York Pizza.
        Ice Cream is: Triple Caramel Chunk.
        Poem is: Along With Youth - Ernest Hemingway.
        Flower is: Tulip.
        Sleepwear is: panties.
        Homestar Runner Character: Animatronic Strong Bad.
        Superhero is: Guardians of the Galaxy.
        Social Media Network is: iWiW.
        Season is: Winter.
        Tree is: Olea europaea.
        Emoji is: üíØ.
        Spectator Sport: Football.
        Cryptid is: Monkey-man of Delhi.
        Simpsons Character is: Blue-Haired Lawyer
        Element is: Astatine - At
        Song is: Papa Was a Rollin' Stone by The Temptations.
        Holiday is: Guy Fawkes Day.
        SCP is: SCP-682-J¬†- SUPER BESTEST LIZERD EVER.
        Album is: Greatest Hits by Queen.
        Steak doneness: Rare - 1.
        Toast Doneness: 5.
        Hot Beverage: Tea.
        Tea/Coffee Colour: D
        Soda is: Caffeine Free Coca-Cola.
        Movie is: Robinson Crusoe on Mars.
        Programming Language is: Pure.
        Animal is: Spider¬†¬†.
        Pokemon is: 875 Eiscue.
        Book is: The Women's Room by Marilyn French.
------------------------------------------------
