###### Your Results Are: ######
Name: Michael Gil Zhuo-Jang, Esq..
Citizen ID Num: 72418FF2AF4562F3
First initial: M, Last initial: Z.
Gender: male. Pronouns: she/her.
DOB: Jun 3, 1945 - Age: 76 years.
Birthplace: NacreÂ .
Primary Citizenship: North Korea
Associate Citizenship(s): Poland, Suriname, Bolivia.
Star Sign: Gemini.
------------------------------------------------
Height: 203.00 cm.
Mass:  74.18 kg.
Beliefs: Eastern Lightning.
Political Party membership: Best Party
Relationship Status: 3 loving partner(s). 
Children: 5 children.
Known allergies: antibiotics.
Blood type: B â‚™áµ¤â‚—â‚—
You are afraid of technology.
Prexisting Health Conditions: Digestion controlled with diet & medication.
Dietary Restrictions: Fruititarian.
Hobbies: Drinking.
Languages: Uyghur, Igbo, Goa'uld and Parallel English.
Occupation: Nuclear Power Reactor Operator.
Security Clearance: None.
Criminal Record: No Criminal Convictions.
Arrest Record: No Arrests on File.
Warrants: No Active Warrants..
Networth: Â¥4394422.67.
Credit Score: 830.
Professional Assn: Investment Adviser Certified Compliance Professional
Highest Education Achieved: Undergraduate.
Last School Attended: Poppleton University.
------------------------------------------------
Your:
        Childhood home was on Oakdale Loke.
        First pet's name was Grindy.
        Childhood best-friend's name is Zhiyong Gong.
        First vehicle:  Mack.
        Mother's maiden name: Hoque.
        Fursona: Unicorn.
        Fighting Style: Gouging.
        Superpower is: The ability to expel a cotton ball from your wrist three times a month.
------------------------------------------------
Your favourite/preferred:
        Colour is: Cadmium orange - #ED872D.
        Food is: Croissant.
        Ice Cream is: Rum Raisin.
        Poem is: The Lion and Albert - Marriott Edgar.
        Flower is: Woolly Violet.
        Sleepwear is: t-shirt and boxer briefs.
        Homestar Runner Character: Videlectrix Guys.
        Superhero is: Captain America.
        Social Media Network is: Ello.
        Season is: Spring.
        Tree is: Rhizophora mangle.
        Emoji is: ðŸ¤¦.
        Spectator Sport: F1 Grand Prix.
        Cryptid is: Mothman.
        Simpsons Character is: Manjula Nahasapeemapetilon
        Element is: Calcium - Ca
        Song is: Lust for Life by Iggy Pop.
        Holiday is: Groundhog Day.
        SCP is: SCP-618Â - Spider on The Wall.
        Album is: Born in the U.S.A. by Bruce Springsteen.
        Steak doneness: Medium - 3.
        Toast Doneness: 3.
        Hot Beverage: Coffee.
        Tea/Coffee Colour: B
        Soda is: Volvic.
        Movie is: Marriage Story.
        Programming Language is: Joule.
        Animal is: Boar.
        Pokemon is: 565 Carracosta~.
        Book is: The Plague by Albert Camus.
------------------------------------------------
