###### Your Results Are: ######
Name: Jimmy Karie Quan-Young.
Citizen ID Num: 288C0F35DEE7207D
First initial: J, Last initial: Q.
Gender: none. Pronouns: she/they.
DOB: Nov 20, 1921 - Age: 100 years.
Birthplace: G889Â .
Primary Citizenship: Gliese 180 c*
Associate Citizenship(s): Trinidad and Tobago, Gliese 832 c, Niger.
Star Sign: Scorpio.
------------------------------------------------
Height: 120.00 cm.
Mass:  41.76 kg.
Beliefs: No strong philosophical or religious beliefs..
Political Party membership: Parti Citron
Relationship Status: Single. 
Children: 2 children.
Known allergies: none.
Blood type: AB â‚™áµ¤â‚—â‚—
You are afraid of buttons.
Prexisting Health Conditions: Pregnancy Complications controlled with diet & medication.
Dietary Restrictions: Ketogenic.
Hobbies: Basketball and Rubik's Cube.
Languages: Spanish, Hausa, Newspeak.
Occupation: Solid Waste Disposal Administrator.
Security Clearance: None.
Criminal Record: No Criminal Convictions.
Arrest Record: No Arrests on File.
Warrants: No Active Warrants..
Networth: Â¥3294573.78.
Credit Score: 774.
Professional Assn: Certified Hospitality Digital Marketer
Highest Education Achieved: Primary School.
Last School Attended: Wrottesley Polytechnic.
------------------------------------------------
Your:
        Childhood home was on Eight Acre Meadow.
        First pet's name was Maude.
        Childhood best-friend's name is Cong Molla.
        First vehicle:  Mack.
        Mother's maiden name: Adams.
        Fursona: None.
        Fighting Style: Huka-huka.
        Superpower is: Changing the colour of anything.
------------------------------------------------
Your favourite/preferred:
        Colour is: Nadeshiko pink - #F6ADC6.
        Food is: Ranch Dressing.
        Ice Cream is: Mission to Marzipan.
        Poem is: Abou Ben Adhem - James Henry Leigh Hunt.
        Flower is: D.
        Sleepwear is: t-shirt and boxers.
        Homestar Runner Character: Count Longardeaux.
        Superhero is: Hawkeye.
        Social Media Network is: Soup.io.
        Season is: Autumn.
        Tree is: Lauraceae.
        Emoji is: ðŸŒŸ.
        Spectator Sport: Fencing.
        Cryptid is: Loch Ness Monster.
        Simpsons Character is: Kumiko Albertson
        Element is: Gold - Au
        Song is: Get Up Stand Up by Bob Marley & The Wailers.
        Holiday is: Boxing Day.
        SCP is: SCP-911Â - Egyptian Book of the Dead.
        Album is: Hysteria by Def Leppard.
        Steak doneness: Blue - 0.
        Toast Doneness: 3.
        Hot Beverage: Earl Grey, hot.
        Tea/Coffee Colour: C
        Soda is: Mello Yello.
        Movie is: The Marriage of Maria Braun.
        Programming Language is: RTL/2.
        Animal is: Orangutan.
        Pokemon is: 698 Amaura.
        Book is: The Horse Whisperer by Nicholas Evans.
------------------------------------------------
