###### Your Results Are: ######
Name: St. Nasir Amberly Ahmad-Su, MCSA.
Citizen ID Num: 28F9F910ACE443E4
First initial: N, Last initial: A.
Gender: complicated. Pronouns: they/them.
DOB: Jul 18, 1979 - Age: 42 years.
Birthplace: Mondas.
Primary Citizenship: Guinea-Bissau
Associate Citizenship(s): Mexico, Lesotho, Saint Vincent and the Grenadines, Saint Lucia, Nicaragua, Canada, Palestine State.
Star Sign: Cancer.
------------------------------------------------
Height: 171.00 cm.
Mass:  84.80 kg.
Beliefs: No strong philosophical or religious beliefs..
Political Party membership: Inanimate Objects Party
Relationship Status: Single. 
Children: 5 children.
Known allergies: nuts.
Blood type: AB ‚Çô‚Çë·µç
You are afraid of fire.
Prexisting Health Conditions: Insomnia controlled with diet & medication.
Dietary Restrictions: Fruititarian.
Hobbies: Palmistry.
Languages: Jin Chinese, German, Lapine.
Occupation: Makeup Artists - Theatrical.
Security Clearance: None.
Criminal Record: No Criminal Convictions.
Arrest Record: No Arrests on File.
Warrants: No Active Warrants..
Networth: ¬•5237376.66.
Credit Score: 558.
Professional Assn: Editor in the Life Sciences
Highest Education Achieved: Undergraduate.
Last School Attended: The University.
------------------------------------------------
Your:
        Childhood home was on Brookway Lane.
        First pet's name was Bler.
        Childhood best-friend's name is Del Kasongo.
        First vehicle:  Chrysler.
        Mother's maiden name: Tan.
        Fursona: Bluejay.
        Fighting Style: Nuba fighting.
        Superpower is: Your fingers cause mechanical devices to seize.
------------------------------------------------
Your favourite/preferred:
        Colour is: English vermillion - #CC474B.
        Food is: Catfish.
        Ice Cream is: Peanut Butter Tracks.
        Poem is: My Country - Dorothea Mackellar.
        Flower is: Meconopsis.
        Sleepwear is: bra and panties.
        Homestar Runner Character: Tenerence Love.
        Superhero is: Doc Savage.
        Social Media Network is: Surfbook.
        Season is: Spring.
        Tree is: Maples.
        Emoji is: üò≠.
        Spectator Sport: Rugby League.
        Cryptid is: Trinity Alps giant salamander.
        Simpsons Character is: Arnie Pye
        Element is: Rubidium - Rb
        Song is: Paint It Black by The Rolling Stones.
        Holiday is: New Year.
        SCP is: SCP-105¬†- "Iris".
        Album is: Unplugged by Eric Clapton.
        Steak doneness: Medium Rare - 2.
        Toast Doneness: 3.
        Hot Beverage: Tea.
        Tea/Coffee Colour: Black - A
        Soda is: Yoo-hoo.
        Movie is: Winter Light.
        Programming Language is: Prolog.
        Animal is: Manatee.
        Pokemon is: 342 Crawdaunt.
        Book is: James and the Giant Peach by Roald Dahl.
------------------------------------------------
