###### Your Results Are: ######
Name: Col. Hongwei Jianmin Miya-Geng, Esq., DM.
Citizen ID Num: C9005B1492C80AFE
First initial: H, Last initial: M.
Gender: female. Pronouns: she/wif.
DOB: Sep 17, 1910 - Age: 111 years.
Birthplace: Sangre¬†.
Primary Citizenship: Somalia
Associate Citizenship(s): Turkey, Fiji.
Star Sign: Virgo.
------------------------------------------------
Height: 115.00 cm.
Mass:  25.13 kg.
Beliefs: No strong philosophical or religious beliefs..
Political Party membership: Beer Lovers Party¬†
Relationship Status: Single. 
Children: 4 children.
Known allergies: aspirin.
Blood type: AB ‚Çô‚Çë·µç
You are afraid of flowers.
Prexisting Health Conditions: Depression controlled with diet & medication.
Dietary Restrictions: Kosher.
Hobbies: Building.
Languages: Hausa, Xiang Chinese, Valyrian and Europanto.
Occupation: Employee Training Instructor.
Security Clearance: None.
Criminal Record: Criminal Convictions on File.
Arrest Record: Arrest Record on File.
Warrants: No Active Warrants..
Networth: ¬•1211251.26.
Credit Score: 655.
Professional Assn: Nationally Registered Emergency Medical Responder¬†(Begin January 1, 2012)
Highest Education Achieved: Doctoral.
Last School Attended: Newport Union.
------------------------------------------------
Your:
        Childhood home was on Harptree Hill.
        First pet's name was Lapis.
        Childhood best-friend's name is Hong Aziz.
        First vehicle:  Hillman.
        Mother's maiden name: Hall.
        Fursona: Whale.
        Fighting Style: China.
        Superpower is: Magic Missile.
------------------------------------------------
Your favourite/preferred:
        Colour is: Golden yellow - #FFDF00.
        Food is: Beef Stroganoff.
        Ice Cream is: Vanilla.
        Poem is: It Couldn‚Äôt Be Done - Edgar Albert Guest.
        Flower is: Diascia.
        Sleepwear is: vets and panties.
        Homestar Runner Character: The Jolly Dumple.
        Superhero is: Zatanna.
        Social Media Network is: Meetro.
        Season is: Spring.
        Tree is: Buchenavia tetraphylla.
        Emoji is: üëá.
        Spectator Sport: Mixed martial arts.
        Cryptid is: Nahuelito.
        Simpsons Character is: Kumiko Albertson
        Element is: Seastone
        Song is: Loco-Motion by Little Eva.
        Holiday is: St. Patrick's Day.
        SCP is: SCP-199¬†- Spy Ferns.
        Album is: Music Box by Mariah Carey.
        Steak doneness: Shoe Leather - 6.
        Toast Doneness: 2.
        Hot Beverage: Coffee.
        Tea/Coffee Colour: B
        Soda is: KickStart.
        Movie is: How to Get Ahead in Advertising.
        Programming Language is: Pure Data.
        Animal is: Owl.
        Pokemon is: 361 Snorunt.
        Book is: The Young Guard by Alexander Alexandrovich Fadeyev.
------------------------------------------------
