###### Your Results Are: ######
Name: Fausto Asha Yadav-Solomon, Jr..
Citizen ID Num: 31115EE67E33F2DE
First initial: F, Last initial: Y.
Gender: female. Pronouns: he/they.
DOB: Jan 9, 1992 - Age: 29 years.
Birthplace: Palamok¬†.
Primary Citizenship: Sri Lanka
Associate Citizenship(s): Guinea-Bissau, Kepler-296e, C√¥te d'Ivoire, Jordan, Finland.
Star Sign: Capricorn.
------------------------------------------------
Height: 267.00 cm.
Mass:  228.12 kg.
Beliefs: Byzantine Catholic Church of Croatia and Serbia.
Political Party membership: Official Monster Raving Loony Party
Relationship Status: Single. 
Children: None.
Known allergies: aspirin.
Blood type: B ‚Çô‚Çë·µç
You are afraid of the figure 8.
Prexisting Health Conditions: Oral Health Issues controlled with diet & medication.
Dietary Restrictions: Words of Wisom.
Hobbies: Digital arts and Building.
Languages: South Levantine Arabic, Poliespo and Bolak.
Occupation: Residence Counselor.
Security Clearance: None.
Criminal Record: No Criminal Convictions.
Arrest Record: No Arrests on File.
Warrants: No Active Warrants..
Networth: ¬•3967228.42.
Credit Score: 840.
Professional Assn: Certified Internal Auditor
Highest Education Achieved: Undergraduate.
Last School Attended: Sweet Valley High.
------------------------------------------------
Your:
        Childhood home was on Blackwell Village.
        First pet's name was Gabriela.
        Childhood best-friend's name is Joie √ñzt√ºrk.
        First vehicle:  Austin.
        Mother's maiden name: Than.
        Fursona: None.
        Fighting Style: Pongyi thaing.
        Superpower is: Self-Mind Reading.
------------------------------------------------
Your favourite/preferred:
        Colour is: Middle green yellow - #ACBF60.
        Food is: Beef Stroganoff.
        Ice Cream is: New York Super Fudge Chunk Ice Cream Bars.
        Poem is: Night of the Scorpion - Nissim Ezekiel.
        Flower is: Urn Plant.
        Sleepwear is: vest and boxer briefs.
        Homestar Runner Character: The Cheat.
        Superhero is: Batwoman.
        Social Media Network is: CarSwap.
        Season is: Autumn.
        Tree is: Hernandia sonora.
        Emoji is: üí•.
        Spectator Sport: Mixed martial arts.
        Cryptid is: Great Spider.
        Simpsons Character is: Helen Lovejoy
        Element is: Elerium-115
        Song is: I Only Have Eyes for You by The Flamingos.
        Holiday is: Groundhog Day.
        SCP is: SCP-616¬†- The Vessel and the Gate.
        Album is: Dirty Dancing by the Motion Picture Cast.
        Steak doneness: Medium Well - 4.
        Toast Doneness: Burnt - 6.
        Hot Beverage: Earl Grey, hot.
        Tea/Coffee Colour: D
        Soda is: Diet Coke Plus.
        Movie is: My Own Private Idaho.
        Programming Language is: Tea.
        Animal is: Oyster.
        Pokemon is: 362 Glalie.
        Book is: What to Expect When You're Expecting by Arlene Eisenberg¬†and¬†Heidi Murkoff.
------------------------------------------------
