###### Your Results Are: ######
Name: Ensign Gladys Khalid Lopez-Xiang, MEM.
Citizen ID Num: 2DFA654C281E4EB4
First initial: G, Last initial: L.
Gender: masc. Pronouns: he/him.
DOB: Oct 23, 1994 - Age: 27 years.
Birthplace: PaxÂ .
Primary Citizenship: Djibouti
Associate Citizenship(s): Togo, Algeria, LHS 1140 b, Burkina Faso, Kepler-452b*, Nepal, Suriname.
Star Sign: Libra.
------------------------------------------------
Height: 83.00 cm.
Mass:  17.22 kg.
Beliefs: No strong philosophical or religious beliefs..
Political Party membership: Surprise Party
Relationship Status: 2 loving partner(s). 
Children: None.
Known allergies: nuts.
Blood type: O â‚™áµ¤â‚—â‚—
You are afraid of ferns.
Prexisting Health Conditions: Gluten sensitivity controlled with diet & medication.
Dietary Restrictions: Vegetarian.
Hobbies: Social media and Car riding.
Languages: Bhojpuri, Poliespo.
Occupation: Community Welfare Worker.
Security Clearance: None.
Criminal Record: No Criminal Convictions.
Arrest Record: No Arrests on File.
Warrants: No Active Warrants..
Networth: Â¥3650753.05.
Credit Score: 832.
Professional Assn: American Board Certified Teacher
Highest Education Achieved: Post-Doc.
Last School Attended: Neptune High.
------------------------------------------------
Your:
        Childhood home was on Balmoral Village.
        First pet's name was Lady Isabel.
        Childhood best-friend's name is Dani Morales.
        First vehicle:  Pierce-Arrow.
        Mother's maiden name: Hassan.
        Fursona: Gray Fox.
        Fighting Style: Historical Scottish Fencing.
        Superpower is: Can predict who will be called next at the DMV.
------------------------------------------------
Your favourite/preferred:
        Colour is: Camel - #C19A6B.
        Food is: Sunday roast.
        Ice Cream is: Coffee Almond Fudge.
        Poem is: From: War Is Kind - Stephen Maria Crane.
        Flower is: Moonflower Vine.
        Sleepwear is: t-shirt.
        Homestar Runner Character: Carnivorous Undead Sheep.
        Superhero is: Sub-Mariner.
        Social Media Network is: JustGarciaHill.org.
        Season is: Summer.
        Tree is: Chrysophyllum albidum.
        Emoji is: ðŸ˜„.
        Spectator Sport: Handball.
        Cryptid is: Honey Island Swamp monster.
        Simpsons Character is: Barney Gumble
        Element is: Truthitonium
        Song is: Dance to the Music by Sly & The Family Stone.
        Holiday is: Diwali.
        SCP is: SCP-015-JÂ - Just Really Misunderstood.
        Album is: Breakfast in America by Supertramp.
        Steak doneness: Medium - 3.
        Toast Doneness: 2.
        Hot Beverage: Bovril.
        Tea/Coffee Colour: C
        Soda is: Pocari Sweat.
        Movie is: Lady Snowblood: Love Song of Vengeance.
        Programming Language is: GAMS (General Algebraic Modeling System).
        Animal is: Booby.
        Pokemon is: 887 Dragapult.
        Book is: War And Peace by Leo Tolstoy.
------------------------------------------------
