###### Your Results Are: ######
Name: Fredrick Anitra Wright-Xiong, IACCP.
Citizen ID Num: 678342121ECF563D
First initial: F, Last initial: W.
Gender: male. Pronouns: they/them.
DOB: Jun 9, 1945 - Age: 76 years.
Birthplace: Morthrai.
Primary Citizenship: Ghana
Associate Citizenship(s): Senegal, Ross 128 b, Kepler-443b, Kepler-1229b.
Star Sign: Gemini.
------------------------------------------------
Height: 123.00 cm.
Mass:  46.90 kg.
Beliefs: Sanatan Sikh.
Political Party membership: Partito della bistecca
Relationship Status: 6 loving partner(s). 
Children: None.
Known allergies: cows' milk.
Blood type: B â‚™áµ¤â‚—â‚—
You are afraid of pain.
Prexisting Health Conditions: Lung Conditions controlled with diet & medication.
Dietary Restrictions: Kosher.
Hobbies: Robot combat and Quilling.
Languages: Northern Kurdish, Spanish, Interlingua.
Occupation: Industrial Machinery Mechanics.
Security Clearance: Counter-Terrorist Check.
Criminal Record: Criminal Convictions on File.
Arrest Record: Arrest Record on File.
Warrants: No Active Warrants..
Networth: Â¥109501.77.
Credit Score: 319.
Professional Assn: Certified Public Manager
Highest Education Achieved: Post Grad - ABD.
Last School Attended: St Luke's University Bristol.
------------------------------------------------
Your:
        Childhood home was on Lloyd Street.
        First pet's name was Tino.
        Childhood best-friend's name is Maryjane Hao.
        First vehicle:  Westcott.
        Mother's maiden name: Sidibe.
        Fursona: None.
        Fighting Style: Kawras.
        Superpower is: The ability to turn into a tree at any moment.
------------------------------------------------
Your favourite/preferred:
        Colour is: Fuchsia (Crayola) - #C154C1.
        Food is: Italian Soda.
        Ice Cream is: The Full VerMonty.
        Poem is: Good-Night - Percy Bysshe Shelley.
        Flower is: Quince.
        Sleepwear is: t-shirt and boxer briefs.
        Homestar Runner Character: Bear Holding a Shark.
        Superhero is: Green Lantern.
        Social Media Network is: Friendster.
        Season is: Winter.
        Tree is: Psidium.
        Emoji is: ðŸ‘‡.
        Spectator Sport: Beach Soccer.
        Cryptid is: Isshii.
        Simpsons Character is: Moe Szyslak
        Element is: Etherium
        Song is: Positively 4th Street by Bob Dylan.
        Holiday is: Yom Kippur.
        SCP is: SCP-976Â - Anomalous Hard Drive.
        Album is: No Jacket Required by Phil Collins.
        Steak doneness: Medium Well - 4.
        Toast Doneness: 3.
        Hot Beverage: Monster.
        Tea/Coffee Colour: C
        Soda is: Bawls.
        Movie is: Star Wars: The Force Awakens.
        Programming Language is: POP-2.
        Animal is: Bison.
        Pokemon is: 804 NaganadelÂ â™¯.
        Book is: The Hunger Games by Suzanne Collins.
------------------------------------------------
