###### Your Results Are: ######
Name: Mario Ines Findlay-Duncan, Sr..
Citizen ID Num: 8A67E7414DCC5A09
First initial: M, Last initial: F.
Gender: nonbinary. Pronouns: ey/em.
DOB: Sep 10, 1964 - Age: 57 years.
Birthplace: Geonosis.
Primary Citizenship: Palau
Associate Citizenship(s): Holy See, Gliese 1061 c, Botswana, Chad, Kyrgyzstan, Georgia.
Star Sign: Virgo.
------------------------------------------------
Height: 112.00 cm.
Mass:  36.38 kg.
Beliefs: No strong philosophical or religious beliefs..
Political Party membership: Imperial British Conservative PartyÂ 
Relationship Status: 7 loving partner(s). 
Children: 5 children.
Known allergies: animal dander.
Blood type: AB â‚™áµ¤â‚—â‚—
You are afraid of books.
Prexisting Health Conditions: Gluten sensitivity controlled with diet & medication.
Dietary Restrictions: Vegan.
Hobbies: Water polo.
Languages: Urdu, Dutch, Ido.
Occupation: Social Science Research Assistants.
Security Clearance: None.
Criminal Record: No Criminal Convictions.
Arrest Record: No Arrests on File.
Warrants: No Active Warrants..
Networth: Â¥3278450.89.
Credit Score: 374.
Professional Assn: CyberSec First Responder
Highest Education Achieved: Undergraduate.
Last School Attended: Christminster University.
------------------------------------------------
Your:
        Childhood home was on Ashwood Link.
        First pet's name was Kell.
        Childhood best-friend's name is Shiv Espinoza.
        First vehicle:  Aptera.
        Mother's maiden name: Santos.
        Fursona: Werewolf.
        Fighting Style: Canne de combat.
        Superpower is: Potato bending.
------------------------------------------------
Your favourite/preferred:
        Colour is: Bittersweet shimmer - #BF4F51.
        Food is: Fried Green Beans.
        Ice Cream is: Duff & D'oh!Nuts.
        Poem is: Moonlit Night: Two Translations - Du Fu.
        Flower is: Agapanthus.
        Sleepwear is: boxers.
        Homestar Runner Character: The Hornblower.
        Superhero is: Conan the Barbarian.
        Social Media Network is: Spaces.
        Season is: Winter.
        Tree is: Elaeagnus angustifolia.
        Emoji is: ðŸ˜“.
        Spectator Sport: Triathlon.
        Cryptid is: Great Spider.
        Simpsons Character is: Comic Book Guy
        Element is: Nobelium - No
        Song is: Welcome to the Jungle by Guns N' Roses.
        Holiday is: Halloween.
        SCP is: SCP-148Â - The "Telekill" Alloy.
        Album is: Music Box by Mariah Carey.
        Steak doneness: Well Done - 5.
        Toast Doneness: White - 0.
        Hot Beverage: Bovril.
        Tea/Coffee Colour: Black - A
        Soda is: Tab Clear.
        Movie is: The Devil Is a Woman.
        Programming Language is: Nix (Systems configuration language).
        Animal is: Orangutan.
        Pokemon is: 571 Zoroark.
        Book is: Norwegian Wood by Haruki Murakami.
------------------------------------------------
