###### Your Results Are: ######
Name: Ling Anil Choe-AntÃ³nio, NBCT.
Citizen ID Num: FD9831DD922A0F35
First initial: L, Last initial: C.
Gender: masc. Pronouns: she/her.
DOB: Sep 24, 1907 - Age: 114 years.
Birthplace: ErythroÂ .
Primary Citizenship: Equatorial Guinea
Associate Citizenship(s): North Korea, Sao Tome and Principe.
Star Sign: Libra.
------------------------------------------------
Height: 264.00 cm.
Mass:  111.51 kg.
Beliefs: Sadharan Brahmo Samaj.
Political Party membership: Raving Loony Green Giant PartyÂ 
Relationship Status: 2 loving partner(s). 
Children: 4 children.
Known allergies: nuts.
Blood type: A â‚™áµ¤â‚—â‚—
You are afraid of strangers or foreigners.
Prexisting Health Conditions: Sleep problems controlled with diet & medication.
Dietary Restrictions: Pescatarian.
Hobbies: Poker and Eating.
Languages: Tamil, Voynich.
Occupation: Tile and Marble Setters.
Security Clearance: None.
Criminal Record: No Criminal Convictions.
Arrest Record: No Arrests on File.
Warrants: No Active Warrants..
Networth: Â¥3479665.61.
Credit Score: 459.
Professional Assn: Chartered Alternative Investment Analyst
Highest Education Achieved: Post-Graduate.
Last School Attended: Edward Tilghman Middle.
------------------------------------------------
Your:
        Childhood home was on Bamford Gait.
        First pet's name was Avu.
        Childhood best-friend's name is Shenita Kasongo.
        First vehicle:  Sterling Trucks.
        Mother's maiden name: Ansari.
        Fursona: None.
        Fighting Style: Hanmudo.
        Superpower is: Can stop your own hair growth.
------------------------------------------------
Your favourite/preferred:
        Colour is: Mahogany - #C04000.
        Food is: Manhattan Clam Chowder.
        Ice Cream is: 'Wich Ice Cream Cookie Sandwich.
        Poem is: The Welsh Hill Country - R S Thomas.
        Flower is: Statice.
        Sleepwear is: bra and panties.
        Homestar Runner Character: Cardboard Marzipan.
        Superhero is: Guardians of the Galaxy.
        Social Media Network is: Slack Exchange.
        Season is: Spring.
        Tree is: Morus mesozygia.
        Emoji is: ðŸ˜‘.
        Spectator Sport: Greyhound Racing.
        Cryptid is: Mongolian death worm.
        Simpsons Character is: Wise Guy
        Element is: Nobelium - No
        Song is: Gimme Shelter by The Rolling Stones.
        Holiday is: May Day.
        SCP is: SCP-419-JÂ - A Trustworthy Man.
        Album is: Gold: Greatest Hits by ABBA.
        Steak doneness: Medium Well - 4.
        Toast Doneness: 2.
        Hot Beverage: Earl Grey, hot.
        Tea/Coffee Colour: Black - A
        Soda is: Liptonice.
        Movie is: Variety Lights.
        Programming Language is: CLIST.
        Animal is: Dog.
        Pokemon is: 870 Falinks.
        Book is: Jonathan Livingston Seagull by Richard Bach.
------------------------------------------------
