###### Your Results Are: ######
Name: St. Lin Hamid Ruiz-Dinh, III.
Citizen ID Num: C9B370973D9BBFCA
First initial: L, Last initial: R.
Gender: nonbinary. Pronouns: she/her.
DOB: Oct 12, 1966 - Age: 55 years.
Birthplace: Gaia .
Primary Citizenship: Samoa
Associate Citizenship(s): Mozambique, Wolf 1061c.
Star Sign: Libra.
------------------------------------------------
Height: 225.00 cm.
Mass:  156.94 kg.
Beliefs: No strong philosophical or religious beliefs..
Political Party membership: Church of the Militant Elvis Party
Relationship Status: 7 loving partner(s). 
Children: 4 children.
Known allergies: insect bites.
Blood type: AB ₙₑᵍ
You are afraid of doctors.
Prexisting Health Conditions: Chronic Pain controlled with diet & medication.
Dietary Restrictions: Fruititarian.
Hobbies: Tattooing.
Languages: Tunisian Arabic, Interslavic.
Occupation: Industrial Hygienist.
Security Clearance: None.
Criminal Record: No Criminal Convictions.
Arrest Record: No Arrests on File.
Warrants: No Active Warrants..
Networth: ¥568362.88.
Credit Score: 311.
Professional Assn: National Board Certified Fellow in Clinical Hypnotherapy
Highest Education Achieved: Undergraduate.
Last School Attended: University of Edgestow.
------------------------------------------------
Your:
        Childhood home was on Deer Park Hey.
        First pet's name was Barnacle.
        Childhood best-friend's name is Elza Sahoo.
        First vehicle:  Columbia.
        Mother's maiden name: Müller.
        Fursona: Luxray.
        Fighting Style: Panganaw.
        Superpower is: Cause people to sneeze.
------------------------------------------------
Your favourite/preferred:
        Colour is: Italian sky blue - #B2FFFF.
        Food is: Madeleine.
        Ice Cream is: Sweet Potato Pie.
        Poem is: Fern Hill - Dylan Thomas.
        Flower is: Parodia.
        Sleepwear is: boxer briefs.
        Homestar Runner Character: Crack in the Wall.
        Superhero is: The Wasp.
        Social Media Network is: Elfwood.
        Season is: Autumn.
        Tree is: Tabebuia rosea.
        Emoji is: ❗.
        Spectator Sport: Weightlifting.
        Cryptid is: British Big Cats.
        Simpsons Character is: Kang & Kodos
        Element is: Unobtanium
        Song is: Goodbye Yellow Brick Road by Elton John.
        Holiday is: Christmas.
        SCP is: SCP-206 - The Voyager.
        Album is: Like a Virgin by Madonna.
        Steak doneness: Blue - 0.
        Toast Doneness: 3.
        Hot Beverage: Monster.
        Tea/Coffee Colour: Black - A
        Soda is: Floats.
        Movie is: Police Story.
        Programming Language is: KRL.
        Animal is: Worm.
        Pokemon is: 680 Doublade.
        Book is: The Story of My Experiments With Truth by Mohandas Karamchand Gandhi.
------------------------------------------------
