###### Your Results Are: ######
Name: Cpl Chanelle Leonore Huang-Ke, Esq., CCE.
Citizen ID Num: 5B3D55EA0DAA7FE9
First initial: C, Last initial: H.
Gender: complicated. Pronouns: she/her.
DOB: Feb 11, 1917 - Age: 104 years.
Birthplace: VineaÂ .
Primary Citizenship: Bangladesh
Associate Citizenship(s): Peru, Niger, Myanmar (formerly Burma), Portugal.
Star Sign: Aquarius.
------------------------------------------------
Height: 219.00 cm.
Mass:  86.33 kg.
Beliefs: No strong philosophical or religious beliefs..
Political Party membership: McGillicuddy Serious PartyÂ 
Relationship Status: Single. 
Children: 1 children.
Known allergies: animal dander.
Blood type: AB â‚™áµ¤â‚—â‚—
You are afraid of mirrors.
Prexisting Health Conditions: Insomnia controlled with diet & medication.
Dietary Restrictions: Ketogenic.
Hobbies: Bowling.
Languages: Jin Chinese, Basic English.
Occupation: Construction Trades Supervisor.
Security Clearance: None.
Criminal Record: No Criminal Convictions.
Arrest Record: No Arrests on File.
Warrants: No Active Warrants..
Networth: Â¥4600685.70.
Credit Score: 468.
Professional Assn: Certified Scrum Master
Highest Education Achieved: Undergraduate.
Last School Attended: McKinley High.
------------------------------------------------
Your:
        Childhood home was on Borough Vale.
        First pet's name was Rocketman.
        Childhood best-friend's name is Vijay Acosta.
        First vehicle:  Dodge.
        Mother's maiden name: James.
        Fursona: Kestrel.
        Fighting Style: Gadayuddha.
        Superpower is: Can forsee the future.
------------------------------------------------
Your favourite/preferred:
        Colour is: Navajo white - #FFDEAD.
        Food is: Mozzarella Sticks.
        Ice Cream is: Cinnamon Ice Cream.
        Poem is: Trapped Dingo - Judith Wright.
        Flower is: Woolly Violet.
        Sleepwear is: vest and boxers.
        Homestar Runner Character: Bad Graphics Ghost.
        Superhero is: Incredible Hulk.
        Social Media Network is: Baidu Space.
        Season is: Spring.
        Tree is: Chamaecyparis thyoides.
        Emoji is: ðŸ¤¤.
        Spectator Sport: Rugby.
        Cryptid is: Orang-bati.
        Simpsons Character is: Troy McClure
        Element is: Meitnerium - Mt
        Song is: Somebody to Love by Jefferson Airplane.
        Holiday is: Easter.
        SCP is: SCP-821Â - Dixie Funland.
        Album is: Gold: Greatest Hits by ABBA.
        Steak doneness: Blue - 0.
        Toast Doneness: done on one side.
        Hot Beverage: Coffee.
        Tea/Coffee Colour: White - F
        Soda is: Coca-Cola Light.
        Movie is: A Generation.
        Programming Language is: Seed7.
        Animal is: African buffalo.
        Pokemon is: 812 Rillaboom.
        Book is: The Very Hungry Caterpillar by Eric Carle.
------------------------------------------------
