###### Your Results Are: ######
Name: Ning Samuel Hong-Mitchell, IV.
Citizen ID Num: 53437B4EF650468B
First initial: N, Last initial: H.
Gender: none. Pronouns: any.
DOB: Feb 9, 1926 - Age: 95 years.
Birthplace: RubanisÂ .
Primary Citizenship: Gliese 3293 d
Associate Citizenship(s): Holy See, Botswana, Pakistan.
Star Sign: Aquarius.
------------------------------------------------
Height: 112.00 cm.
Mass:  35.12 kg.
Beliefs: Spiritual Christianity.
Political Party membership: Beer Lovers Party
Relationship Status: 7 loving partner(s). 
Children: 5 children.
Known allergies: cows' milk.
Blood type: A â‚šâ‚’â‚›
You are afraid of social evaluation.
Prexisting Health Conditions: Pregnancy Complications controlled with diet & medication.
Dietary Restrictions: Gluten-free.
Hobbies: Outdoors and Birdwatching.
Languages: South Levantine Arabic, Mondial.
Occupation: Hardwood Floor Finisher.
Security Clearance: None.
Criminal Record: No Criminal Convictions.
Arrest Record: No Arrests on File.
Warrants: No Active Warrants..
Networth: Â¥5770049.39.
Credit Score: 550.
Professional Assn: Residential Appraiser
Highest Education Achieved: Post-Doc.
Last School Attended: For-Profit Online University.
------------------------------------------------
Your:
        Childhood home was on Newlyn East.
        First pet's name was Winston.
        Childhood best-friend's name is Olga Mallik.
        First vehicle:  VPG.
        Mother's maiden name: Bello.
        Fursona: None.
        Fighting Style: Krav Maga.
        Superpower is: You can breath underwater.
------------------------------------------------
Your favourite/preferred:
        Colour is: Ming - #36747D.
        Food is: Scrambled Eggs With Cheese.
        Ice Cream is: Goodbye Yellow Brick Road.
        Poem is: When We Two Parted - George Gordon Byron.
        Flower is: Catmint.
        Sleepwear is: t-shirt.
        Homestar Runner Character: Imaginary Friends.
        Superhero is: Wonder Woman.
        Social Media Network is: Playfire.
        Season is: Autumn.
        Tree is: Juniperus foetidissima.
        Emoji is: ðŸ’˜.
        Spectator Sport: Netball.
        Cryptid is: Steller's sea ape.
        Simpsons Character is: Ruth Powers
        Element is: Bohrium - Bh
        Song is: Under the Boardwalk by The Drifters.
        Holiday is: Islamic Holidays.
        SCP is: SCP-381Â - The Pyrotechnic Polyphony.
        Album is: Nevermind by Nirvana.
        Steak doneness: Medium - 3.
        Toast Doneness: 5.
        Hot Beverage: Earl Grey, hot.
        Tea/Coffee Colour: E
        Soda is: Tab Energy.
        Movie is: The Lord of the Rings: The Return of the King.
        Programming Language is: dc.
        Animal is: Ox.
        Pokemon is: 713 Avalugg.
        Book is: Sophieâ€™s World by Jostein Gaarder.
------------------------------------------------
