###### Your Results Are: ######
Name: Vicente Satish Shahzad-Castillo, HCCP.
Citizen ID Num: F3E5067BD113F103
First initial: V, Last initial: S.
Gender: female. Pronouns: they/them.
DOB: Jul 11, 1943 - Age: 78 years.
Birthplace: Death WindÂ .
Primary Citizenship: India
Associate Citizenship(s): Djibouti, Uzbekistan, Portugal, Nepal, Venezuela, Mr. Lee's Greater Hong Kong, Gliese 1061 d.
Star Sign: Cancer.
------------------------------------------------
Height: 119.00 cm.
Mass:  38.23 kg.
Beliefs: Congregational churches.
Political Party membership: Partido del Karma DemocrÃ¡tico
Relationship Status: Single. 
Children: 1 children.
Known allergies: none.
Blood type: B â‚šâ‚’â‚›
You are afraid of the color black.
Prexisting Health Conditions: UTI controlled with diet & medication.
Dietary Restrictions: Ketogenic.
Hobbies: Seashell collecting.
Languages: Maithili, Hindi, Khuzdul.
Occupation: Legal Assistant.
Security Clearance: None.
Criminal Record: Criminal Convictions on File.
Arrest Record: Arrest Record on File.
Warrants: No Active Warrants..
Networth: Â¥3916585.05.
Credit Score: 834.
Professional Assn: Certified Orthotist
Highest Education Achieved: Post Grad - ABD.
Last School Attended: Lowlands University.
------------------------------------------------
Your:
        Childhood home was on Tiddy Close.
        First pet's name was Victor.
        Childhood best-friend's name is Jack Zapata.
        First vehicle:  Scion.
        Mother's maiden name: Thapa.
        Fursona: None.
        Fighting Style: Tahtib.
        Superpower is: Offspring Detection.
------------------------------------------------
Your favourite/preferred:
        Colour is: Emerald - #50C878.
        Food is: Catfish.
        Ice Cream is: Pecan Pie.
        Poem is: Prayers To Lord Murugan - A.K. Ramanujan.
        Flower is: Oriental Poppy.
        Sleepwear is: vest and trousers.
        Homestar Runner Character: The Geddup Noise.
        Superhero is: The Defenders.
        Social Media Network is: AIM.
        Season is: Summer.
        Tree is: Olea europaea.
        Emoji is: ðŸ™„.
        Spectator Sport: Table Tennis.
        Cryptid is: Dobhar-chÃº.
        Simpsons Character is: Selma Bouvier
        Element is: Transformium
        Song is: La Bamba by Ritchie Valens.
        Holiday is: Guy Fawkes Day.
        SCP is: SCP-756Â - Miniature Solar System.
        Album is: Legend: The Best of Bob Marley & The Wailers by Bob MarleyÂ & The Wailers.
        Steak doneness: Medium Rare - 2.
        Toast Doneness: done on one side.
        Hot Beverage: Bovril.
        Tea/Coffee Colour: E
        Soda is: Fantasy.
        Movie is: The Haunted Strangler.
        Programming Language is: NESL.
        Animal is: Duck.
        Pokemon is: 535 Tympole.
        Book is: Fifty Shades trilogy by EL James.
------------------------------------------------
