###### Your Results Are: ######
Name: Bill Letty Torres-David, II.
Citizen ID Num: 472C1B8690755AA0
First initial: B, Last initial: T.
Gender: male. Pronouns: he/were.
DOB: Feb 10, 1967 - Age: 54 years.
Birthplace: Nacre .
Primary Citizenship: Suriname
Associate Citizenship(s): Slovakia, Kepler-283c, Suriname, Kepler-296e, Gabon, Oman, Congo (Congo-Brazzaville).
Star Sign: Aquarius.
------------------------------------------------
Height: 83.00 cm.
Mass:  13.09 kg.
Beliefs: No strong philosophical or religious beliefs..
Political Party membership: The Civilian Party 
Relationship Status: 3 loving partner(s). 
Children: None.
Known allergies: nuts.
Blood type: A ₙₑᵍ
You are afraid of the color purple.
Prexisting Health Conditions: UTI controlled with diet & medication.
Dietary Restrictions: Words of Wisom.
Hobbies: Painting.
Languages: Sanaani Spoken Arabic, Kēlen and Mondial.
Occupation: Health Case Manager.
Security Clearance: None.
Criminal Record: No Criminal Convictions.
Arrest Record: No Arrests on File.
Warrants: No Active Warrants..
Networth: ¥3546142.80.
Credit Score: 493.
Professional Assn: Master of Music
Highest Education Achieved: Undergraduate.
Last School Attended: Riverdale High.
------------------------------------------------
Your:
        Childhood home was on Link Warren.
        First pet's name was Pando.
        Childhood best-friend's name is Mohamed Mohsen.
        First vehicle:  Crosley.
        Mother's maiden name: Cook.
        Fursona: Snow Leopard.
        Fighting Style: Tao (spear).
        Superpower is: Superpowered Mood Swings.
------------------------------------------------
Your favourite/preferred:
        Colour is: Dark cornflower blue - #26428B.
        Food is: Mole.
        Ice Cream is: Honey.
        Poem is: Solitude - Ella Wheeler Wilcox.
        Flower is: Start with C.
        Sleepwear is: boxers.
        Homestar Runner Character: The Prince of Town.
        Superhero is: Superman.
        Social Media Network is: The Sphere.
        Season is: Spring.
        Tree is: Sideroxylon obovatum.
        Emoji is: ☝️.
        Spectator Sport: Weightlifting.
        Cryptid is: Yeti.
        Simpsons Character is: Homer Simpson
        Element is: Nickel - Ni
        Song is: Hey Ya! [Radio Mix] by OutKast.
        Holiday is: St. Patrick's Day.
        SCP is: SCP-895 - Camera Disruption.
        Album is: Hybrid Theory by Linkin Park.
        Steak doneness: Medium - 3.
        Toast Doneness: Burnt - 6.
        Hot Beverage: Bovril.
        Tea/Coffee Colour: D
        Soda is: Hires Root Beer.
        Movie is: A Generation.
        Programming Language is: Sather.
        Animal is: Sole.
        Pokemon is: 510 Liepard.
        Book is: Great Expectations by Charles Dickens.
------------------------------------------------
