###### Your Results Are: ######
Name: Marlene Donna Mohamed-Akter, USNR.
Citizen ID Num: CB48F07F878A70D8
First initial: M, Last initial: M.
Gender: nonbinary. Pronouns: he/they.
DOB: Jun 3, 1956 - Age: 65 years.
Birthplace: ZillikianÂ .
Primary Citizenship: Morocco
Associate Citizenship(s): Papua New Guinea, Eritrea, Albania, Uganda, El Salvador, Japan.
Star Sign: Gemini.
------------------------------------------------
Height: 213.00 cm.
Mass:  77.13 kg.
Beliefs: No strong philosophical or religious beliefs..
Political Party membership: The Civilian PartyÂ 
Relationship Status: Single. 
Children: 1 children.
Known allergies: animal dander.
Blood type: B â‚™áµ¤â‚—â‚—
You are afraid of witches and witchcraft.
Prexisting Health Conditions: Digestion controlled with diet & medication.
Dietary Restrictions: Words of Wisom.
Hobbies: Chess and Hunting.
Languages: Polish, Latino sine Flexione.
Occupation: Livestock Commission Agent.
Security Clearance: None.
Criminal Record: No Criminal Convictions.
Arrest Record: No Arrests on File.
Warrants: No Active Warrants..
Networth: Â¥1496128.52.
Credit Score: 794.
Professional Assn: Association of Licensed Architects Member
Highest Education Achieved: Masters.
Last School Attended: Ackley Bridge College.
------------------------------------------------
Your:
        Childhood home was on Fourth Acre.
        First pet's name was Herb.
        Childhood best-friend's name is Sabrina Mousa.
        First vehicle:  Jeep.
        Mother's maiden name: Fan.
        Fursona: Chakat.
        Fighting Style: Juego de manÃ­.
        Superpower is: Door Manipulation.
------------------------------------------------
Your favourite/preferred:
        Colour is: Alabaster - #EDEAE0.
        Food is: Macaroni and Cheese.
        Ice Cream is: Vanilla Malted Milk.
        Poem is: may i feel said he - E.e. cummings.
        Flower is: Poinsettia.
        Sleepwear is: t-shirt and panties.
        Homestar Runner Character: The Hornblower.
        Superhero is: Marvelman.
        Social Media Network is: Faves.com.
        Season is: Autumn.
        Tree is: Genipa americana.
        Emoji is: ðŸ¤—.
        Spectator Sport: Snowboarding.
        Cryptid is: Kraken.
        Simpsons Character is: Kumiko Albertson
        Element is: Technetium - Tc
        Song is: Money (That's What I Want) by Barrett Strong.
        Holiday is: Groundhog Day.
        SCP is: SCP-363Â - Not Centipedes.
        Album is: All the Way... A Decade of Song by Celine Dion.
        Steak doneness: Blue - 0.
        Toast Doneness: 3.
        Hot Beverage: Monster.
        Tea/Coffee Colour: White - F
        Soda is: Copella.
        Movie is: The Music Room.
        Programming Language is: Pict.
        Animal is: Cockroach.
        Pokemon is: 687 Malamar.
        Book is: The Celestine Prophecy by James Redfield.
------------------------------------------------
