###### Your Results Are: ######
Name: Kamal Shu Anh-Ni, IV.
Citizen ID Num: 6772FFB65771B8ED
First initial: K, Last initial: A.
Gender: male. Pronouns: ey/em.
DOB: Aug 21, 1943 - Age: 78 years.
Birthplace: FuryaÂ .
Primary Citizenship: Senegal
Associate Citizenship(s): Belize, Jamaica, Kapteyn b*, Liberia, Iceland, Bahamas.
Star Sign: Leo.
------------------------------------------------
Height: 137.00 cm.
Mass:  46.92 kg.
Beliefs: Bongthingism.
Political Party membership: Adam Lyal's Witchery Tour PartyÂ 
Relationship Status: Single. 
Children: None.
Known allergies: antibiotics.
Blood type: A â‚™áµ¤â‚—â‚—
You are afraid of Halloween.
Prexisting Health Conditions: Oral Health Issues controlled with diet & medication.
Dietary Restrictions: Halal.
Hobbies: Bus riding.
Languages: German, Malayalam, Interlingua and Idiom Neutral.
Occupation: Ophthalmologist (MD).
Security Clearance: None.
Criminal Record: Criminal Convictions on File.
Arrest Record: Arrest Record on File.
Warrants: No Active Warrants..
Networth: Â¥1863168.37.
Credit Score: 383.
Highest Education Achieved: Masters.
Last School Attended: University of Burston.
------------------------------------------------
Your:
        Childhood home was on Wallis Newydd.
        First pet's name was Ruzzo.
        Childhood best-friend's name is Manju Abubakar.
        First vehicle:  Ginetta.
        Mother's maiden name: Yousuf.
        Fursona: Lion/Tiger.
        Fighting Style: American Kenpo.
        Superpower is: Can turn music into beams of light.
------------------------------------------------
Your favourite/preferred:
        Colour is: Frostbite - #E936A7.
        Food is: Cabeza Tacos.
        Ice Cream is: Rachel's Brownie.
        Poem is: Myfanwy - Sir John Betjeman.
        Flower is: Borage.
        Homestar Runner Character: Tom Servo.
        Superhero is: Elektra.
        Social Media Network is: DeviantArt.
        Season is: Autumn.
        Tree is: Vitis vinifera.
        Emoji is: ðŸ‘‰.
        Spectator Sport: Beach Soccer.
        Cryptid is: Iemisch.
        Simpsons Character is: Todd Flanders
        Element is: SCP-148
        Song is: Monkey Gone to Heaven by Pixies.
        Holiday is: Hanukkah.
        SCP is: SCP-269Â - Dialysis Bracelet.
        Album is: Whitney by Whitney Houston.
        Steak doneness: Medium - 3.
        Toast Doneness: 3.
        Hot Beverage: Tea.
        Tea/Coffee Colour: Black - A
        Soda is: La Croix Sparkling Water.
        Movie is: Great Expectations.
        Programming Language is: WebAssembly.
        Animal is: Cricket.
        Pokemon is: 745 Lycanroc.
        Book is: The Joy of Sex by Alex Comfort.
------------------------------------------------
